I Ain't Worried - OneRepublic 
Caribbean Queen - Billy Ocean 
Let's Hear It For The Boy - Deniece Williams 
The Whistler And His Dog - Arthur Pryor Band 
Do-Re-Mi - Julie Andrews 
Centerfold - J.Geils Band 
Working For The Weekend - Loverboy 
Save Your Tears - The Weeknd, Ariana Grande 
Know Me Too Well - New Hope Club & Danna Paola 
California Dreamin' - Sia 
One Foot - Walk The Moon 
Dancing In The Moonlight - Toploader 
Dynamite - BTS
Africa - Toto 
De Do Do Do De Da Da Da - The Police 
On The Floor - Jennifer Lopez 
Scatman (ski-ba-bop-ba-dop-bop) - Scatman John 
Save The Best For Last - Vanessa Williams 
Listen To My Heart - Gareth Gates 
Don't Worry Be Happy - Bobby McFerrin 
When You're In Love With A Beautiful Woman - Dr.Hook 
I'm In The Mood For Dancin' - The Nolans 
Vacation - Go Go's 
Walking On Sunshine -  Katrina And The Waves 
Rivers Of Babylon - Boney M 
Shake Your Booty - K.C And The Sunshine Band 
Feeling So Good - The Archies 
Rag Doll - Frankie Vall & The Four Seasons 
The Empty Chair - Sting 
High Hopes - Panic! At The Disco 
I'd Love You To Want Me - Lobo 
Only You (And You Alone)  - The Platters 
Wonderful Tonight - Eric Clapton 
Together Forever - Rick Astley 
Pick Up The Phone - F.R.David 
Sk8er Boi  - Avril Lavigne 
Potion - Calvin Harris, Dua Lipa, Young Thug
Rise - Jonas Blue (Feat. Jack & Jack)
What's Up - 4 Non Blondes 
Make You Feel My Love - Adele
Moon River - Audrey Hepburn 
Memory - Barbra Streisand
Rain And Tears - Aphrodite's Child 
Aline - Christophe 
Who'll Stop The Rain - CCR
Don't Play Your Rock And Roll To Me - Smokie 
Remember Me - Miguel & Natalia Lafourcade 
Bam Bam - Camila Cabello (feat. Ed Sheeran) 
Sign - Ace Of Base
Sign Of The Times - Harry Styles 
A Whiter Shade Of Pale - Procol Harum 
The Temple Of The King - Rainbow 
All By Myself - Celine Dion 
One Moment In Time - Whitney Houston 
A Kind Of Magic - Queen 
Out Of Time - The Weeknd 
Grace - ADOY 
Long Goodbyes - Camel 
Roar - Katy Perry 
Lemon Tree - Fool's Garden 
Lovefool - The Cardigans 
When I Dream - Carol Kidd 
Have You Ever Really Loved A Woman - Bryan Adams 
Wake Me Up - Avicii
Run - OneRepublic 
Midnight Blue - Electric Light Orchestra
Lost Stars - Keira Knightley 
You Win Again - Bee Gees 
Early In The Morning - Cliff Richard 
Oh, Pretty Woman - Roy Orbison 
Who Says - Selena Gomez And The Scene 
Perfect - Anne Marie 
Angel Baby - Troye Sivan 
Nothing On You - B.O.B (Feat. Bruno Mars) 
Un Roman D'amitie - Elsa & Glenn Medeiros 
Stand By Me - Ben E. King 
I Just Fall In Love Again - Anne Murray 
Ob-La-Di, Ob-La-Da - The Beatles
9 To 5 - Dolly Parton 
Waterloo - ABBA
Listening For The Weather - Bic Runga 
Happy! - Mocca 
Beat It - Michael Jackson 
The Heat Is On - Glenn Frey 
Hard To Say I'm Sorry - 이소라 
Knife - Rockwell
Hotel - Claire Rosinkranz 
Who Are You - The Who 
Believe - Cher 
Around The World (Lalalalala) - ATC
I Like Chopin - Gazebo 
Miss Me Blind - Culture Club 
Angel - Forestella 
Open Arms - Journey 
Big Big World - Emilia 
Uptown Funk - Jamie Cullum 
Lambada  / Kaoma 
Puff The Magic Dragon / Peter, Paul & Mary 
Today / John Denver 
As Long As You Love Me / Backstreet Boys 
Smooth Operator / Sade 
From A Distance / Bette Midler 
Bridge Over Troubled Water / Simon And Garfunkel 
Livin' On A Prayer - Bon Jovi 
Maria / Blondie  
Quizas, Quizas, Quizas / Trio Los Panchos 
Barbie Girl / Aqua 
Go West / Pet Shop Boys
Sun Of Jamaica / Goombay Dance Band 
Dancing in the Moonlight / Toploader 
Kids In America / Kim Wilde 
Don't Fall In Love With A Dreamer - Kenny Rogers 
End Of The Road / Boyz II Men 
Fame  / Irene Cara
Lonesome Loser   / Little River Band  
Can't Fight The Moonlight - LeAnn Rimes 
You've Got A Friend - Carole King 
Smile - Rod Stewart 
Do You Know Where You're Going To - Diana Ross 
Da Doo Ron Ron -Shaun Cassidy 
Fantasia - Pooh 
Put Your Hand in the Hand - Ocean
Knock Three Times -Tony Orlando & Dawn 
When Will I See You Again- The Three Degrees 
Un-Break My Heart - Toni Braxton
Copacabana (At the Copa) - Barry Manilow 
Let's Get Retarded - Black Eyed Peas 
Sexy Back - Justin Timberlake 
Family Affair - Mary J. Blige
Got To Be Real - Cheryl Lynn 
Let's Groove - Earth, Wind & Fire 
We Are Family - Sister Sledge
Stayin' Alive - Bee Gees 
Hungry Like The Wolf - Duran Duran
Bad Case Of Loving You (Doctor, Doctor) - Robert Palmer 
ANOTHER DAY OF SUN - LA LA LAND CAST 
EASY - COMMODORES 
LEAVE THE DOOR OPEN - SILK SONIC 
RING MY BELL - ANITA WARD  
SEPTEMBER - EARTH, WIND AND FIRE
MY ALL - MARIAH CAREY  
I'LL MAKE LOVE TO YOU - BOYZ II MEN
THE WAY - FASTBALL
ALL YOU NEED IS LOVE - THE BEATLES 
CIRCLE OF LIFE - CARMEN TWILLIE LEBO M. 
SAN FRANCISCO - SCOTT MCKENZIE 
BUILD ME UP BUTTERCUP - THE FOUNDATIONS
DREAMS - FLEETWOOD MAC 
I WAS BORN TO LOVE YOU - QUEEN
DREAM A LITTLE DREAM - LAURA FYGI
CHANSON D'AMOUR - THE MANHATTAN TRANSFER
TONIGHT - NEW KIDS ON THE BLOCK 
TAKE ON ME - A-HA 
VENUS - BANANARAMA
LOVE IS IN YOUR EYES - GERARD JOLING  
STAND BY YOUR MAN - CARLA BRUNI  
HALLELUJAH - LEONARD COHEN
SENORITA - SHAWN MENDES, CAMILLA CABELLO 
LEVITATING - DUA LIPA
TIME AFTER TIME - CYNDI LAUPER 
I JUST CALLED TO SAY I LOVE YOU - STEVIE WONDER 
SUBSTITUTE FOR LIFE - THE REAL GROUP 
DYNAMITE - BTS 
MAMAN LA PLUS BELLE DU MONDE - LUIS MARIANO 
COME BACK - J. GEILS BAND  
SAILING - ROD STEWART
PARADISE - PHOEBE CATES 
SUN OF JAMAICA - GOOMBAY DANCE BAND
TO BE WITH YOU - MR. BIG 
DO THAT TO ME ONE MORE TIME - CAPTAIN AND TENNILLE 
TO BE WITH YOU - MR. BIG 
LADY MARMALADE - CHRISTINA AGUILERA IL' KIM MYA PINK
UPTOWN GIRL - BILLY JOEL
DREAM ON - NAZARETH 
THE GREAT PRETENDER - FREDDIE MERCURY
EVERGREEN - BARBRA STREISAND 
I AM I SAID - NEIL DIAMOND 
THERE SHE GOES - SIXPENCE NONE THE RICHER
BASKET CASE - GREEN DAY
YOU RAISE ME UP - WESTLIFE 
ORINOCO FLOW - ENYA
LIFE IS COOL - SWEET BOX
ON TOP OF THE WORLD - IMAGINE DRAGONS
VIVA LA VIDA - COLDPLAY
SUMMER WINE - NANCY SINATRA, LEE HAZELWOOD 
I AIN'T WORRIED - ONEREPUBLIC (탑건 매버릭 OST)
MAPS - MAROON 5 
ANNIE'S SONG / JOHN DENVER 
SING / CARPENTERS 
ELECTRIC YOUTH - DEBBIE GIBSON 
SURFING USA - LEIF GARRETT
HOLIDAY - BEE GEES
SUMMER BREEZE - SEALS AND CROFTS
TORN - NATALIE IMBRUGLIA
COME ON OVER (ALL I WANT IS YOU) / CHRISTINA AGUILERA
MMMBOP / HANSON
WANNABE / SPICE GIRLS
I CAN SEE CLEARLY NOW / JIMMY CLIFF
KOKOMO / BEACH BOYS
BACK FOR GOOD / TAKE THAT
I'VE NEVER BEEN TO ME / CHARLENE
JUST THE TWO OF US / GROVER WASHINGTON, JR. BILL WITHERS
WHEN YOU WISH UPON A STAR / JUDY COLLINS
TRY EVERYTHING / SHAKIRA
CANCION DEL MARIACHI (MORENA DE MI CORAZON) /  LOS LOBOS ANTONIO BANDERAS
LET'S GET LOUD / JENNIFER LOPEZ
IT'S A HEARTACHE / BONNIE TYLER 
FAITHFULLY / JOURNEY
TOXIC / BRITNEY SPEARS
STRONGER (WHAT DOESN'T KILL YOU) / KELLY CLARKSON
THE ROAD TO MANDALAY / ROBBIE WILLIAMS
LIVE IS LIFE / OPUS
IN DREAMS / ROY ORBISON
SUN FLOWER - GLENN CAMPBELL
PAPER MACHE / RITA CALYPSO  
QUANDO, QUANDO, QUANDO / MICHAEL BUBLE NELLY FURTADO
FRESH / KOOL AND THE GANG
ROCK WITH YOU / MICHAEL JACKSON
ISLANDS IN THE STREAM / DOLLY PARTON 
MORNING TRAIN / SHEENA EASTON 
ALL I WANNA DO / SHERYL CROW 
PLAYGROUND IN MY MIND / CLINT HOLMES 
BROTHER LOUIE / MODERN TALKING
A LOVER'S CONCERTO / SARAH VAUGHAN
THIS WILL BE (AN EVERLASTING LOVE) / NATALIE COLE
ONE LOVE / BLUE
AI NO CORRIDA / CHARLES MAY
NOW AND FOREVER / RICHARD MARX
GIRL / THE BEATLES 
MANIC MONDAY / BANGLES
SHAKE IT UP / THE CARS
PERFECT / ED SHEERAN
Wouldn’t It Be Nice - The Beach Boys 
Aubrey - Bread  
Only Yesterday - Isla Grant 
Les Champs Elysees - Daniele Vidal 
Ohio - Isabelle Adjani
Fly Me To The Moon - Julie London 
New York, New York - Frank Sinatra & Tony Bennett 
Emotions - Mariah Carey  
Come On Over - Christina Aguilera 
Life Is Wonderful - Jason Mraz 
Part-Time Lover - Stevie Wonder 
La Isla Bonita - Madonna 
How Will I Know - Whitney Houston 
Logical Song - Supertramp 
Down Under - Men At Work 
Stay With Me Till The Morning - Dana Winner 
Woman In Love - Barbra Streisand 
Rock With You - Michael Jackson 
No One - Alicia Keys 
Versace On The Floor - Bruno Mars 
Checklist - MAX (Feat. Chromeo)
Knock Three Times - Tony Orlando & Dawn 
Yellow River - Christie 
You’ve Got A Friend - Carole King 
After The Love Has Gone - Earth, Wind & Fire 
Tonight - New Kids On The Block 
Hungry Heart - Bruce Springsteen
Mama - Spice Girls   
No Matter What - Boyzone
Turn Back Time - Aqua 
Big Girl - Mika
Red Red Wine - UB40 
Baby I Love Your Way - Big Mountain 
99 Red Balloons - Nena
Baba O’Riley - The Who
Don't Know Much - Linda Ronstadt & Aaron Neville 
True Colors - Cyndi Lauper 
I Want To Know What Love Is - Foreigner 
Need You Now - Lady Antebellum
Can't Stop The Feeling! - Justin Timberlake 
Hands Up - Ottawan 
Just Wanna Dance Tonight - Trix 
Breezy - Wouter Hamel 
Sunroof - Nicky Youre, dazy
Lost In Love - Air Supply 
Straight From My Heart - Richard Marx 
Love Is - Vanessa Williams & Brian McKnight 
Three Little Birds - Connie Talbot 
Fighter - Christina Aguilera 
Baby One More Time - Britney Spears 
Don't Push Me - Sweetbox 
Home - Michael Buble 
Have I Told You Lately - Rod Stewart
Touch By Touch - Joy 
You're My Heart You're My Soul - Modern Talking 
Paso  (The Nini Anthem)  - Sak Noel 
Marry You - Bruno Mars 
Lean On Me - Bill Withers 
Stand By Your Man - Carla Bruni 
Can't Take My Eyes Off You - Morten Harket
When I Need You - Leo Sayer 
Living Next Door To Alice - Smokie 
Duet - Rachael Yamagata
Yellow - Coldplay 
Unchained Melody - The Righteous Brothers 
Reality - Richard Sanderson 
Only When I Sleep - 이은주 
Holiday - Bee Gees 
Once There Was A Love - Jose Feliciano 
Happy Together - Danny Chung 
Lambada - Kaoma 
One More Time - In-Grid 
Separate Ways - Journey 
Stay - Ghostly Kisses 
I Just Wanted You - Openside 
Parachute - John K 
Who Let The Dogs Out - Baha Men 
Nothing From Nothing - Billy Preston 
Rock'n Me - Steve Miller Band
Best Of My Love - The Emotions 
Ring My Bell - Anita Ward 
I Was Born To Love You - Queen 
Juliet - LMNT 
A Moment Like This - Kelly Clarkson 
Everybody Hurts - R.E.M. 
I Have A Dream - ABBA
Just When I Needed You Most - Randy Vanwarmer 
Just Tell Me You Love Me - England Dan & John Ford Coley 
Rewrite The Stars - Zac Efron, Zendaya 
Rise Up - Andra Day 
Counting Stars - OneRepublic
Heart Of Glass - Blondie 
Shout - Tears For Fears 
Love Me Like You Do - Ellie Goudling 
this is what falling in love feels like - JVKE 
The Time Of My Life - Bill Medley & Jennifer Warnes 
Don't You Want Me - The Human League 
Shake It Up - The Cars 
Let Me Be There - Olivia Newton John 
Please Mr.Postman - Carpenters 
Hound Dog - Elvis Presley 
Tutti Frutti - Little Richard 
I Will Survive - Gloria Gaynor 
About Damn Time - Lizzo 
Sails - Chet Atkins 
Danger Zone - Kenny Loggins 
Hall Of Fame - The Script (feat. will.i.am) 
Unstoppable - Sia 
One Way Ticket - Eruption 
Kiss In The Dark - Pink Lady 
Supreme - Robbie Williams 
Rosanna - Toto 
Getting To The Point - Electric Light Orchestra 
Bette Davis Eyes - Kim Carnes 
Blinding Lights - The Weeknd 
Getting Better - New Hope Club 
Da Doo Ron Ron - Shaun Cassidy 
Do Wah Diddy Diddy - Manfred Mann
Un Roman D'amitie - Elsa & Glenn Medeiros 
Still - Commodores 
Going Back West - Boney M 
Kung Fu Fighting - Carl Douglas 
Shut Up - Mia Rodriguez 
Late Night Talking - Harry Styles 
Hold On - Wildson Phillips 
We Built This City - Starship 
Sultans Of Swing - Dire Straits 
Hey Brother - Avicii 
Latin Lover - Popsie 
She Loves Control - Camila Cabello 
Bad Habits - Ed Sheeran 
As Long As You Love Me - Backstreet Boys 
Thinking Of You - ATC
Take My Breath Away - Berlin 
Love Love Love - Hope (Feat. Jason Mraz) 
Walk Right In - Dr.Hook 
Bad Moon Rising - CCR 
Up Where We Belong - Joe Cocker & Jennifer Warnes 
A Love That Will Never Grow Old - Emmylou Harris
Jump - Van Halen 
Hold The Line - Toto
Brave - Jennifer Lopez 
No Scrubs - TLC
Dancing In The Dark - Bruce Springsteen 
Saddle The Wind - Lou Christie 
Plasir D'Amour - Nana Mouskouri 
The Morning After - Maureen Mcgovern
Lemon Tree - Fool’s Garden 
Crazy Love - Mindy Gledhill 
Cruel Summer - Ace Of Base
Uptown Girl - Westlife 
Title - Meghan Trainor 
When I Fall In Love - Celine Dion, Clive Griffin 
I Can Love You Like That - All-4-One
La Bamba - Los Lobos
Sweat (A La La La La Long) - Inner Circle
Celebration - Kool And The Gang 
첨밀밀 - 등려군 
River Blue - Alain Morisod & Sweet People 
I'm Yours - Jason Mraz 
Photograph - Ed Sheeran 
Don't Let The Sun Go Down On Me - Elton John & George Michael 
Without You - Mariah Carey 
Blurred Lines - Robin Thicke (Feat. T.I. / Pharrell Williams ) 
Power Of Love - Celine Dion 
Everytime You Go Away - Paul Young
Missing You - John Waite
Let It Be - The Beatles 
Don't Look Back In Anger - Oasis 
Wherever You Will Go - The Calling 
Power Of Love - Helene Fischer 
St. Elmo's Fire (Man In Motion) - John Parr 
Y.M.C.A - Village People 
Genghis Khan - Genghis Khan 
Islands In The Stream - Dolly Parton, Kenny Rogers 
Come And Get Your Love - Redbone 
Coffee - Quinn Xcii, Marc E.Bassy
sheluvme - Tai Verdes 
Mocking Bird Hill - Patti Page 
Strangers In The Night - Frank Sinatra 
Cold Cold Man - Saint Motel 
Under Pressure - Queen 
Andante, Andante - ABBA 
You Are My Sunshine - Elizabeth Mitchell Daniel Littleton 
One Summer Night - 진추하, 아비 
Too Much Heaven - Bee Gees 
Kokomo - Beach Boys
Waka Waka - Shakira 
She Bangs - Ricky Martin 
Want To Want Me - Jason Derulo 
Physical - Dua Lipa 
Sunny - Boney M 
Never Gonna Give You Up - Rick Astley 
Gloria - Laura Branigan 
Get It On (Bang A Gong) - T.Rex 
When Doves Cry - Prince 
Kids Are Born Stars - Lauv 
I Just Called - Neiked, Anne-Marie, Latto 
A Shoulder To Cry On - Tommy Page 
Reflections Of My Life - Marmalade 
Eye Of The Tiger - Survivor 
You Call It Love - Karoline Kruger 
If You Don't Know Me By Now - Simply Red 
One Call Away - Charlie Puth 
sunburn - almost monday 
Angel Of The Morning - Juice Newton 
Love Of My Life - Queen 
The Sound Of Silence - Simon And Garfunkel 
Vincent - Don McLean 
A Lover's Concerto - 진혜림 
Now And Forever - Richard Marx 
Say You Love Me - M.Y.M.P
Raindrops Keep Falling On My Head - B.J.Thomas
Alone Again - Gilbert O'sullivan 
It's Raining Men - Geri Halliwell 
Beat It - Michael Jackson 
Take Your Time - The S.O.S Band 
Everybody's Talking - Harry Nilsson 
My Universe - Coldplay, BTS 
Sisyphus - Andrew Bird 
Creep - Radiohead 
Can't Help Falling In Love - Kacey Musgraves 
Dancing With Your Ghost - Sasha Alex Sloan 
Another Day - Dream Theater 
The Stranger - Billy Joel 
Take On Me - A-ha 
Glimpse of Us - Joji 
It's My Life - Bon Jovi 
Born To Be Alive - Patrick Hernandez 
Do You Wanna Funk - Sylvester 
Love Will Keep Us Together - Captain And Tennille 
Don't Go Breaking My Heart - Elton John Kiki Dee 
Better Days - Neiked, Mae Muller, Polo G 
Jiggle Jiggle - Duke Jones, Louis Theroux 
Old Town Road - Lil Nas X (feat. Billy Ray Cyrus) 
Make It With You - Bread 
Sailing - Christopher Cross
Always On My Mind - Pet Shop Boys 
My Love - Westlife 
If You Come To Me - Atomic Kitten 
Stand By Me - Ben E. King 
My Heart Is An Open Book - Carl Dobkins Jr. 
Dizzy - Tommy Roe 
Wannabe - Spice Girls
Around The World - Aqua 
Believer - Imagine Dragons 
Nothing's Gonna Change My Love For You - George Benson 
Dance The Night Away - The Mavericks
Dancing Queen - ABBA
I Only Want To Be With You - Bay City Rollers 
You're Only Lonely - J.D.Souther 
How Deep Is Your Love - Bee Gees 
Gonna Fly Now - Bill Conti 
A Fifth Of Beethoven - Walter Murphy 
Harbor Lights - The Platters 
I Like It Like That - Chris Kenner 
Because Of You - Kelly Clarkson 
Danger Zone - Kenny Loggins 
Nothing's Gonna Stop Us Now - Starship 
Dreaming - Blondie 
Left And Right - Charlie Puth, 정국 (Feat. Jung Kook Of BTS) 
Crazy AF - In Real Life 
Like My Father - Jax 
San Francisco - Scott Mckenzie 
Travellin' - Jeremy Spencer Band 
Burning Love - Elvis Presley 
Bad, Bad Leroy Brown - Jim Croce 
La Da Dee - Cody Simpson
Any Dream Will Do - Jason Donovan
Dreamin’ - Cliff Richard 
I Love Your Smile - Shanice 
Easy - Commodores 
You Can Do Magic - America 
Tequila Sunrise - Eagles
Kiss Of Life - Sade
On The Beach - Chris Rea 
Feel - Robbie Williams 
Somewhere Over The Rainbow / What A Wonderful World - Israel Kamakawiwo'ole
Green Green Grass Of Home - Tom Jones 
Stoney - Lobo 
Make You Feel My Love - Adele
Angel Baby - Troye Sivan 
Faithfully - Journey
All For Love - Rod Stewart, Bryan Adams, Sting 
It Must Have Been Love - Roxette 
I Don’t Care - Ed Sheeran, Justin Bieber  
There’s Nothing Holding Me Back - Shawn Mendes 
Surf City - Jan And Dean 
Mexican Girl - Smokie 
Volare - Gypsy Kings 
Bleeding Love - Leona Lewis 
Right Here Waiting - Richard Marx 
Stay - The Kid LAROI, Justin Bieber 
The Drum - Alan Walker 
Rock The Boat - The Hues Corporation 
Emotion - Samantha Sang 
Eye In The Sky - Alan Parsons Project 
Top Of The World - Carpenters 
Sea Of Heartbreak - Poco 
Sad Cafe - Eagles 
I Ain't Worried - OneRepublic
Cake By The Ocean - DNCE 
Latin Lover - Popsie 
Caribbean Queen - Billy Ocean 
Shake Your Love - Debbie Gibson 
Darling - SURAN, Peder Elias 
Good News - DARKMINDS
Macarena - Los Del Rio 
Joyride - Roxette 
My Sharona - The Knack 
At My Worst - Pink Sweat$ (Feat. Kehlani) 
Every Second - Mina Okabe 
Perhaps Love - John Denver Placido Domingo 
You Raise Me Up - Westlife 
Moonlight Serenade - Lisa Ono 
Dancing In The Moonlight - Toploader 
Happy - Helen Austin 
Hotel California - Eagles 
Evergreen - Susan Jacks 
Woman - John Lennon 
Sweet Child O'Mine - Guns N' Roses 
Mayonaise - Smashing Pumpkins 
Hung Up - Madonna 
Wanted - Dooleys 
Dragostea Din Tei - O-Zone 
Dreams - The Cranberries 
Wake Me Up Before You Go Go - Wham 
The Loco-Motion - Kylie Minogue 
(I Just) Died In Your Arms - Cutting Crew 
Bad Case Of Loving You - Robert Palmer 
2002 - Anne Marie 
As It Was - Harry Styles 
Splendor In The Grass - Pink Martini 
Here Is Your Paradise - Chris De Burgh 
Sugar Town - Nancy Sinatra 
Words - F.R. David 
Fame - Irene Cara 
Ghostbusters - Ray Parker Jr. 
In The Navy - Village People 
Piano Man - Billy Joel 
Spring, Summer, Winter And Fall - Aphrodite's Child 
Mamma Mia - ABBA 
Chilly Cha Cha - Jessica Jay 
Know Me Too Well - New Hope Club Danna Paola 
Physical - Olivia Newton John 
Billie Jean - Michael Jackson 
Call Me - Blondie 
Save Your Tears - The Weeknd, Ariana Grande 
I Was Made For Lovin' You - Oliver Heldens 
Every Breath You Take - Police
Hurts So Good - John Cougar Mellencamp 
Your Eyes - Cook Da Books 
Summer Holiday - Cliff Richard 
This Is Me - Keala Settle The Greatest Showman Ensemble 
Perfect Symphony - Ed Sheeran (With Andrea Bocelli) 
Bridge Over Troubled Water - Josh Groban Brian McKnight 
Queen Of Hearts - Juice Newton 
Sweet Sweet Smile - Carpenters 
Moves Like Jagger - Maroon 5 (Feat. Christina Aguilera) 
Boom - X Ambassadors 
Bomba - Jessy Matador 
Bring It All Back - S Club 7
Beautiful Soul -Jesse McCartney 
Magic - Pilot 
Daddy Cool - Boney M 
She Works Hard For The Money - Donna Summer 
Kings & Queens - Ava Max 
Stronger (What Doesn't Kill You) - Kelly Clarkson 
Take Me Home Country Roads - John Denver 
Kodachrome - Paul Simon 
How Far I'll Go - Auli'l Cravalho 
Try Everything - Shakira 
Everyday I Love You - Boyzone 
Where Is The Love? - Black Eyed Peas & Justin Timberlake 
Because You Loved Me - Celine Dion 
25 Minutes - Michael Learns To Rock 
Go West - Pet Shop Boys 
Tarzan Boy - Baltimora 
Footloose - Kenny Loggins 
Senorita - Shawn Mendes, Camila Cabello 
Take You Dancing - Jason Derulo 
Lucky - Jason Mraz & Colbie Caillat 
Let's Twist Again - Chubby Chucker 
It's So Easy - Linda Ronstadt 
Honey Honey - ABBA
We Are Young - Fun (Feat. Janelle Monae)
Walking The Wire - Imagine Dragons 
Girls Just Want To Have Fun - Cyndi Lauper 
Heartbeat - Wham 
Reflection - Christina Aguilera 
Let It Go - Idina Menzel 
Free - Lenka
Every Teardrop Is A Waterfall - Coldplay 
Life Is Cool - Sweetbox 
Under The Sea - A-Teens 
Kokomo - Beach Boys 
All About You - Mcfly 
Altogether Alone - Be The Voice 
Quando, Quando, Quando  - Moon (혜원) 
Save The Last Dance For Me - Michael Buble 
Summer Feelings - Lennon Stella (feat. Charlie Puth) 
One Kiss - Calvin Harris & Dua Lipa 
Happy Girl - Together
Puff (The Magic Dragon) - Peter, Paul And Mary 
The Lion Sleeps Tonight - The Tokens 
Return To Innocence - Enigma 
Orinoco Flow - Enya
Some Kind Of Friend - Barry Manilow 
Maneater - Hall & Oates 
Shadow Dancing - Andy Gibb 
I Feel Love - Donna Summer 
Sleeping Child - Michael Learns To Rock
Last Train To London - Electric Light Orchestra 
When I Kissed The Teacher - Lily James, Jessica Keenan Wynn, Alexa Davies, Celia Imrie 
I Can’t Decide - Scissor Sisters 
That Thing You Do - The Wonders 
Hello - Joy 
Backseat Of Your Cadillac - C.C. Catch 
Almaz - Randy Crawford 
Le Restaurant - Brenda Russell
I Sing You Sing - Real Group 
Java Jive - The Manhattan Transfer 
Maria Elena - Xavier Cugat 
She's Like The Wind - Patrick Swayze (Feat. Wendy Fraser) 
Listen To Your Heart - Roxette 
Storm Song - Phildel 
Biblical - Calum Scott 
If You Think You Know How To Love Me - Smokie 
Just One Look - Linda Ronstadt 
All For The Love Of A Girl - Johnny Horton 
Don't Forget To Remember - Bee Gees 
Ellie, My Love - Ray Charles 
Love Is A Wonderful Thing - Michael Bolton 
Working For The Weekend - Loverboy 
Back In Black - AC/DC 
Fight Song - Rachel Platten 
Champion - Bishop Briggs 
Africa - Toto 
Against The Wind - Bob Seger And The Silver Bullet Band 
Shivers - Ed Sheeran 
Light Switch - Charlie Puth 
Gravity - Sara Bareilles 
Come On Let's Go - Los Lobos
Karma Chameleon - Culture Club 
Did You See Me Coming? - Pet Shop Boys
Torn - Natalie Imbruglia 
What's Up - 4 Non Blondes 
Maniac - Michael Sembello 
Two Of Hearts - Stacey Q
Leave The Door Open - Bruno Mars, Anderson.Paak, Silk Sonic
double take - Dhruv 
Let It Be - The Beatles 
Don't Let Me Be Misunderstood - Santa Esmeralda 
Centerfold - J.Geils Band 
Venus - Bananarama 
Call Me Maybe - Carly Rae Jepsen 
Thnkin Bout You - Ciara 
You're Still The One - Shania Twain 
Mandy - Westlife 
Don't Stop Me Now - Queen 
Origin Of Love - Mika
Rain Is Falling - Electric Light Orchestra
How Where When? - Cleo Laine James Galway 
If - Sissel 
It's Raining Again - Supertramp 
Love Grows - Edison Lighthouse 
Making Love Out Of Nothing At All - Air Supply 
Never Gonna Fall In Love Again - Eric Carmen 
Love Of My Life - The Dooleys 
You Mean Everything To Me - Neil Sedaka 
I Remember You - Skid Row 
Rain - Jose Feliciano 
Silvery Rain - Olivia Newton John 
Famous Blue Raincoat - Leonard Cohen 
Coffee - Grace 
You Know I'm No Good - Amy Winehouse 
Glimpse of Us - Joji 
Someone Like You - Adele 
Pretty Woman - Roy Orbison 
I Love A Rainy Night - Eddie Rabbitt
In Your Letter - Reo Speedwagon 
Warwick Avenue - Duffy 
Only Love Can Hurt Like This - Paloma Faith 
Ben - Michael Jackson 
Lean On Me - Bill Withers
Marvin Gaye - Charlie Puth (Feat. Meghan Trainor) 
My Type - Saint Motel 
La La Means I Love You - Delfonics 
Happy Song - Boney M 
One Night In Bangkok - Murray Head
Rock Me Amadeus - Falco 
Lay All Your Love On Me - ABBA 
I Ain't Worried - OneRepublic 
I Found Heaven - Take That 
When I Dream - Carol Kidd
Rainbow - Kacey Musgraves 
This City - Sam Fischer 
Honey, There's The Door - Haley Reinhart 
Early In The Morning - Cliff Richard 
Take On Me - Pentatonix 
Happy! - Mocca 
Scarborough Fair - Sarah Brightman 
A Whiter Shade Of Pale - Procol Harum 
Indian Reservation - Raiders 
House Of The Rising Sun - The Animals 
Everything At Once - Lenka 
Littlest Things - Lily Allen 
Space Man - Sam Ryder 
Angel - 유채훈, 박기훈, 구본수 
Nowhere Fast - Fire Inc. 
Far From Over - Frank Stallone 
Dance Monkey - Tones And I 
Numb - Marshmello, Khalid 
Stack It Up - Liam Payne (Feat. A Boogie Wit Da Hoodie) 
Stickwitu - Pussycat Dolls 
Listen To My Heart - Gareth Gates 
The Rose - Bette Midler 
Mickey - Toni Basil 
Danger Zone - Kenny Loggins 
Self Control - Laura Branigan 
Rainy Days And Mondays - Carpenters 
I Can't Tell You Why - Eagles 
Juice - Lizzo 
Say So - Doja Cat
Story Of My Life - One Direction 
Morning Has Broken - Cat Stevens 
Big Big World - Emilia 
Breathless - The Corrs 
Sugar - Maroon 5
Happy - Pharrell Williams 
Have Fun, Go Mad - Blair 
Uptown Funk - Mark Ronson, Bruno Mars 
All By Myself - Celine Dion 
How Am I Supposed To Live Without You - Michael Bolton 
Me And My Broken Heart - Rixton 
Milk And Toast And Honey - Roxette
Butterfly - Nicole  
California Blue - Roy Orbison 
Mademoiselle De Paris - Daniele Vidal 
Mon Mec A Moi - Patricia Kaas 
Remember Me - Miguel & Natalia Lafourcade 
Kingston Town - UB 40 
Smooth Operator - Sade
I Like It - DeBarge 
All At Once - Whitney Houston
Hello - Lionel Richie 
Young Hearts Run Free - Candi Staton 
I Wanna Be Your Lover - Prince 
Il Mondo - Jimmy Fontana 
You Are So Beautiful - Joe Cocker
Moody's Mood For Love (I'm In The Mood For Love) - Quincy Jones (Feat. James Moody, Brian McKnight , Take 6, Rachelle Ferrell)
Let’s Make Love - Fourplay 
Dancing Into The Moonlight - D’sound 
Sunday Morning - Maroon 5
Drunk In The Morning - Lukas Graham  
Life Is A Flower - Ace Of Base 
Sing - Carpenters 
Blackbird -Sarah McLachlan
It Might Be You - Stephen Bishop  
Sometimes When We Touch - Dan Hill 
You Can Set Me Free - Coo Coo
Never Too Late - Kylie Minogue 
The Luckiest - Ben Folds 
Hero - Family Of The Year 
I Just Called - Neiked, Anne-Marie, Latto 
Lea - Toto  
Welcome To My World - The Anita Kerr Singers 
She - Elvis Costello 
Never My Love - Association
I’m Still Standing - Elton John
Believe It Or Not- Joey Scarbury
There She Goes - Sixpence None The Richer 
Clean & Dirty - Harvard
Don’t Say Goodbye - Sergio Mendes, John Legend
Desafinado - Lovisa 
You Are My Sunshine - Papa Winnie 
Someone To Love - Jon B Babyface 
I'll Be There - Mariah Carey Trey Lorenz 
Photograph - Ranum 
Goodnight Moon - Shivaree 
Isn't She Lovely - Stevie Wonder 
Celebration - Kool And The Gang 
Total Eclipse Of The Heart - Bonnie Tyler 
Crying In The Rain - A-ha 
You Light Up My Life - Debby Boone 
Touch By Touch - Joy 
Sweet Dreams - Eurythmics 
Twilight Zone - 2 Unlimited 
Holiday - Scorpions 
Forbidden Colours - Ryuichi Sakamoto David Sylvian 
Shape Of My Heart - Sting 
More Than I Can Say - Leo Sayer 
Love Today - Mika 
I'm Too Sexy - Right Said Fred 
I Beg Your Pardon - Kon Kan 
I.O.U - Carry & Ron 
Alone - Heart 
Sugar - Robin Schulz (Feat. Francesco Yates) 
Hurts So Good - John Cougar Mellencamp 
Lucky Strike - Maroon 5 
Colors Of The Wind - Vanessa Williams 
Better In Time - Leona Lewis 
Piano Man - Billy Joel 
Bridge Over Troubled Water - Simon And Garfunkel 
Finish Line - Elton John, Stevie Wonder 
Rise Up - Andra Day 
Senorita - Shawn Mendes, Camila Cabello 
On The Floor - Jennifer Lopez 
Maniac - Conan Gray 
About Damn Time - Lizzo 
Vincent - Don McLean 
(Everything I Do) I Do It For You - Bryan Adams 
Where Does My Heart Beat Now - Celine Dion 
All Of The Stars - Ed Sheeran 
Lost Stars - Adam Levine 
You Win Again - Bee Gees 
Xanadu - Olivia Newton John 
Late Night Talking - Harry Styles 
Let It Go - James Bay
Nella Fantasia - Sarah Brightman 
I'm In The Mood For Dancin' - The Nolans 
Jump (For My Love) - Pointer Sisters 
Sweet Soul Music - London Boys 
Aline - Christophe 
Love Me, Please Love Me - Michel Polnareff 
La Vita E Bella - Nicola Piovani 
Starstruck - Years & Years
Levitating - Dua Lipa 
The Nights - Avicii
Sun Of Jamaica - Goombay Dance Band 
Barbie Girl - Aqua 
Another Night - Real McCoy 
How Can I Tell Her - Lobo 
Stumblin' In - Suzi Quatro & Chris Norman 
Immigrant Song - Led Zeppelin 
Hush - Kula Shaker 
I Only Wanna Be With You - Samantha Fox 
The Loco-Motion - Kylie Minogue 
Rocky Mountain High - John Denver 
Victory - Koreana 
Waterloo - ABBA
Hot Stuff - Donna Summer 
Go West - Pet Shop Boys 
Sway - Pussycat Dolls 
Savannah Woman - Tommy Bolin 
Smooth - Santana (Feat. Rob Thomas) 
Don't Worry Be happy - Bobby Mcfferrin 
Oh Happy Day - The St.Francis (Feat. Ryan Toby) 
Too Much Love Will Kill You - Queen 
Don't You Worry 'Bout A Thing - Tori Kelly 
Let's Groove - Earth, Wind And Fire
You're The First, The Last, My Everything - Barry White
Not Going Anywhere - Keren Ann
Love - Sam Ock 
Reality - Richard Sanderson 
Up Where We Belong - Joe Cocker & Jennifer Warnes 
Viva La Vida - Coldplay 
Do You Hear The People Sing? - Claude-Michel Schonberg 
Final Countdown - Europe
One Moment In Time - Whitney Houston 
This Is Me - Keala Settle & The Greatest Showman Ensemble 
Take My Breath Away - Berlin 
Hold My Hand - Lady Gaga 
You're The Reason - Etham 
Hard To Say I'm Sorry - Chicago 
Here I Am - Air Supply 
Dust In The Wind - Kansas 
El Condor Pasa (If I Could) - Simon And Garfunkel 
Love Me Tender - Elvis Presley 
For The Peace Of All Mankind - Albert Hammond 
My Melody Of Love - Bobby Vinton 
Through The Fire - Chaka Khan 
Again - Janet Jackson 
Single Ladies (Put A Ring On It) - Beyonce 
Buttons - Pussycat Dolls 
Hey Soul Sister - Train 
You Belong With Me - Taylor Swift 
Hello Darlin’ - Lynn Anderson  
The ‘I Love You’ Song - Miss Claudia And Pornorama & W.JJ Jones  
Fallen - Lauren Wood
Dream A Little Dream - Beautiful South  
I Feel The Earth Move - Carole King 
Roll With It - Steve Winwood 
Keep The Fire Burnin' - Reo Speedwagon 
Owner Of A Lonely Heart - Yes 
Dreams - Fleetwood Mac 
Still Fighting It - Ben Folds Five
This Is The Last Time - Keane 
Ob-La-Di, Ob-La-Da - The Beatles 
Candida - Tony Orlando & Dawn 
Hey Tonight - CCR (Creedence Clearwater Revival) 
Waiting For A Star To Fall - Boy Meets Girl 
Tell It To My Heart - Taylor Dayne 
Wasted Days And Wasted Nights - Freddy Fender 
We Don't Talk Anymore - Cliff Richard 
Sexy Music - The Nolans 
Body Language - The Dooleys 
One Way Ticket - Eruption 
(I Like) The Way You Love Me - Michael Jackson 
Pretty World - Lisa Ono 
Wave - Antonio Carlos Jobim 
Bella Luna - Jason Mraz 
Lay Me Down - Sam Smith 
Fallin' - Alicia Keys 
Still With You - Eric Benet 
The Tide Is High - Blondie
Uptown Girl - Westlife 
Off My Face- Justin Bieber 
Good Time - Carly Rae Jepsen & Owl City 
Starting Over Again - Natalie Cole 
Can't Take My Eyes Off You - Morten Harket 
Rivers Of Babylon - Boney M 
Can't Stop Lovin' You - Van Halen 
Sit Still, Look Pretty - Daya
Oops - Little Mix (Feat. Charlie Puth) 
Power Of Love - Laura Branigan 
Stand By Me - Ben E.King 
Everybody's Changing - Keane 
Try Everything - Shakira 
Leap Of Faith - Christopher 
We Are Young - Fun. (Feat. Janelle Monae) 
Rolling In The Deep - Adele
Chandelier - Sia 
Crazy - Gnarls Barkely 
Babe - Styx 
Sara Smile - Hall And Oates 
One More Cup Of Coffee - Bob Dylan & Emmylou Harris 
Just The Way You Are - Billy Joel 
Kissing A Fool - George Michael 
Creep - Karen Souza 
Every Breath You Take - The Police 
Cold Heart - Elton John, Dua Lipa 
Mercy - Duffy 
Shape Of You - J.Fla 
Old And Wise - The Alan Parsons Project 
Circles - Post Malone 
Gloria - Laura Branigan 
She's Gone - Steelheart 
Always - Bon Jovi 
A Summer Place - Percy Faith His Orchestra
Summer Wine - Nancy Sinatra Lee Hazlewood 
Casablanca - Bertie Higgins 
Lost In Love - Air Supply 
When I Need You - Leo Sayer 
Paris In The Rain - Lauv 
Pinocchio - Daniele Vidal 
Ex-Fan Des Sixties - Jane Birkin 
Raindrops Keep Fallin' On My Head - B.J. Thomas 
Magic Moments - Perry Como 
I'm Not The Only One - Sam Smith 
Dancing With Your Ghost - Sasha Alex Sloan 
When A Man Loves A Woman - Michael Bolton 
Still Got The Blues - Gary Moore 
Tiny Dancer - Elton John 
Fix You - BTS
Don't Look Back In Anger - Oasis 
Bohemian Rhapsody - Queen 
Always Remember Us This Way - Lady Gaga 
Englishman In New York - Sting 
Sisyphus - Andrew Bird 
No Direction - Rachael Yamagata 
Holidays - Michel Polnareff 
Spring, Summer, Winter And Fall - Aphrodite's Child 
Open Arms - Journey 
Dance With Me - Orleans 
Leave A Tender Moment Alone - Billy Joel 
The Time Of My Life - Bill Medley Jennifer Warnes
Part-Time Lover - Stevie Wonder 
Make It Mine - Jason Mraz 
Count On Me - Connie Talbot 
You Call It Love - Karoline Kruger
Lead Me On - Maxine Nightingale 
Problem - Ariana Grande (Feat. Iggy Azalea) 
Kung Fu Fighting - Carl Douglas 
I Will Survive - Gloria Gaynor 
Stayin' Alive - Bee Gees 
One Night Only - Beyonce, Sharon Leal, Anika Noni Rose
Let Me Love You Tonight - Pure Prairie League 
Listen To The Music - The Doobie Brothers 
Curame - Javier Rios 
Liquid Lunch - Caro Emerald 
Waiting For Love - Avicii 
A Sky Full Of Stars - Coldplay 
I Should Be So Lucky - Kylie Minogue
Nothing's Gonna Stop Us Now - Starship 
Manic Monday - Bangles 
Quando, Quando, Quando - Moon (혜원)
Alone Again - 이소라 
Another One Bites The Dust - Queen 
Bad Guy - Billie Eilish 
Don't Stop Believin' - Journey 
Yesterday - The Beatles 
You Make My Life A Better Place - Mamas Gun 
Legend - The Score 
Hands Up - Ottawan 
Call Me - Spagna 
Wake Me Up Before You Go-Go - Wham!
Evergreen - Susan Jacks 
Annie's Song - John Denver 
Take On Me - A-ha 
As It Was - Harry Styles
Out Of Time - The Weeknd 
Dreams - The Cranberries 
Fernando - Cher & Andy Garcia
Summer Nights - John Travolta, Olivia Newton John
Songbird - Anne Murray
The Young Ones - Cliff Richard
All For The Love Of A Girl - Johnny Horton
Sometimes - Britney Spears
I Want It That Way - Backstreet Boys
True - Spandau Ballet 
Memories - Maroon 5
I Can Wait Forever - Air Supply 
Yesterday Once More - Carpenters
Both Sides Now - Joni Mitchell 
House Of The Rising Sun - The Animals 
Solitary Man - Neil Diamond 
50 Ways To Say Goodbye - Train
Don’t Make My Brown Eyes Blue - Crystal Gayle
Lotta Love - Nicolette Larson 
Tonight - New Kids On The Block
Romantic - Karyn White  
Sympathique (Je Ne Veux Pas Travailler) - Pink Martini 
Escape - Rupert Holmes 
Kingston Town - UB40
You Belong To Me - Carla Bruni 
Bubbly - Colbie Caillat 
L'estate Sta Finendo - Righeira 
Bahama Mama - Boney M 
Saturday In The Park - Chicago 
Love Foolosophy - Jamiroquai 
Feels - Calvin Harris (Feat. Pharrell Williams, Katy Perry, Big Sean)
Amazed - Lonestar 
The Sign - Ace Of Base 
Don't You Want Me - The Human League 
Romeo - Donna Summer 
Love Is Like Oxygen - Sweet 
Are You Ready - AC/DC 
Who Are You - The Who 
2 Become 1 - Spice Girls 
Pretty Boy - M2M 
Titanium - David Guetta & Sia 
In Un'altra Vita - Forestella 
Spread Your Wide Wings - Sissel 
Here Is Your Paradise - Chris De Burgh 
I'd Love You To Want Me - Lobo 
Three Times In Love - Tommy James 
Words - F.R.David
Me And Michael - MGMT 
Don't Push Me - Sweetbox 
Song Of Life - Libera 
See You Again - One Voice Children's Choir 
Gimme Gimme Gimme - ABBA 
Do You Wanna Funk - Sylvester 
Break My Heart - Dua Lipa 
Stairway To Heaven - Led Zeppelin 
You Give Love A Bad Name - Bon Jovi 
How Deep Is Your Love - Bee Gees 
I Love Your Smile - Shanice 
I Will Wait For You - Lisa Lovbrand 
Truly - Lionel Richie 
You Are My Lady - Freddie Jackson 
Killing Me Softly With His Song - Roberta Flack 
Careless Whisper - Wham 
Puttin' On The Ritz - Taco 
Bang Bang - Nancy Sinatra 
Feel It Steel - Portugal. The Man 
So Sad And Alone - Citizen Jane
Rain And Tears - Aphrodite's Child 
Honesty - Billy Joel 
I Don't Like To Sleep Alone - Paul Anka 
Could I Have This Dance - Anne Murray 
It's A Sin - Pet Shop Boys 
Harlem Desire - London Boys 
Everybody (Backstreet's Back) - Backstreet Boys 
Stand By Your Man - Tammy Wynette 
Sorry Seems To Be The Hardest Word - Blue Elton John 
Come Fly With Me - Frank Sinatra
If You Leave Me Now - Chicago 
Baby Come Back - Player 
My Heart Will Go On - Celine Dion 
Make You Feel My Love - Adele 
Our Last Summer - Amanda Seyfried, Colin Firth, Meryl Streep, Pierce Brosnan, Stellan Skarsgard 
Seasons Of Love - Jonathan Larson 
Together Forever - Rick Astley 
Love In The First Degree - Bananarama 
Do Somethin' - Britney Spears
Runaway - Bon Jovi 
Bad Case Of Loving You - Robert Palmer 
One Way Or Another - Blondie 
Everybody Wants You - Billy Squier 
Save Your Tears - The Weeknd, Ariana Grande 
Know Me Too Well - New Hope Club Danna Paola 
Strawberries Cigarettes - Troye Sivan 
Missing You - John Waite 
Have You Ever Really Loved A Woman - Bryan Adams 
Without You - Mariah Carey 
Good Morning Baltimore - Nikki Blonsky 
Another Day Of Sun - La La Land Cast
Save The Last Dance For Me - Michael Buble 
Paint My Love - Michael Learns To Rock 
My Love - Westlife 
Back At One - Brian Mcknight 
I Wanna Know - Joe 
Wannabe - Spice Girls 
Jam - Michael Jackson 
Mr. Blue Sky - Electric Light Orchestra 
Te Quiero Baby (I Love You Baby) - Chesca, Pitbull, Frankie Valli 
Whenever, Wherever - Shakira 
Despacito - Luis Fonsi Daddy Yankee (Feat. Justin Bieber) 
I'm Yours - Jason Marz
2002 - Anne Marie, Ed Sheeran 
At My Worst - Pink Sweat$ (feat. Kehlani) 
Hotel California - Eagles 
(Sittin' On) The Dock Of The Bay - Otis Redding 
Caribbean Blue - Enya 
When The Children Cry - White Lion 
The Prayer - Celine Dion & Andrea Bocelli 
I Still Believe - 조수미 
We're All Alone - Rita Coolidge 
Just Tell Me You Love Me - England Dan & John Ford Coley 
It's Raining Men - Geri Halliwell 
Fame - Irene Cara 
Sign Of The Times - Harry Styles 
We Are One - Kelly Sweet
You And I - Scorpions 
Love Of My Life - Queen 
Shallow - Lady Gaga, Bradley Cooper 
The Blower's Daughter - Damien Rice 
Say Something - A Great Big World & Christina Aguilera 
GHOST TOWN - Benson Boone 
My Eyes Adored You - Frankie Valli 
You Mean Everything To Me - Neil Sedaka 
Shadows In The Moonlight - Anne Murray 
A Whole New World - Peabo Bryson & Regina Belle
Slow Motion Bossa Nova - Celso Fonseca, Ronaldo Bastos 
When You're In Love With A Beautiful Woman - Dr. Hook
You've Got A Friend In Me - Randy Newman 
Moonlight Shadow  - Mike Oldfield 
Telephone Line - Electric Light Orchestra 
Loving You - Minnie Ripperton 
Feel Like Makin' Love -Roberta Flack
Torn - Natalie Imbruglia  
Soak Up The Sun - Sheryl Crow 
Socker - Kent  
Unchained Melody - The Righteous Brothers
Listen - Beyonce
You Gotta Be - Des’ree 
Kodachrome - Paul Simon 
Making Your Mind Up - Bucks Fizz
Think About Me - Fleetwood Mac  
We Don't Talk About Bruno - 영화 엔칸토 OST 중에서  
Bam Bam - Camila Cabello (Feat. Ed Sheeran)
You're The Inspiration - Chicago
Summer In The City - The Lovin’ Spoonful 
Wishing It Was You - Connie Francis  
Am I That Easy To Forget? - Engelbert Humperdinck  
My Girl - Temptations 
Woman In Love - Barbra Streisand
I Knew You Were Waiting (For Me) - Aretha Franklin & George Michael
When You Believe- Mariah Carey & Whitney Houston
Almost Paradise - Mike Reno & Ann Wilson 
Burning Heart - Survivor
Summer Of ’69 - Bryan Adams 
Angel Of The Morning - Juice Newton
Let There Be Love - Laura Fygi
Unforgettable -  Nat King Cole  & Natalie Cole
Romeo’s Tune - Steve Forbert 
Half The Way - Crystal Gayle 
Show Me The Way - Peter Frampton 
Passion - Rod Stewart
You Are The One - A-ha 
Life Is Cool - Sweetbox 
Come On Over (All I Want Is You) - Christina Aguilera 
Happy! - Mocca 
Ain't No Mountain High Enough - Marvin Gaye Tammi Terrell 
Can't Give You Anything (But My Love) - Stylistics 
One Summer Night - 진추하, 아비 
Even Now - Nana Mouskouri 
I Like Chopin - Gazebo 
Wanted - The Dooleys 
Summer Is For Falling In Love - Sarah Kang 
San Francisco Street - Sun Rai
Amnesia - Virginia To Vegas 
A Lover's Concerto - Sarah Vaughan 
Here Comes The Sun - James Taylor Yo-Yo Ma 
You're Only Lonely - J.D. Souther 
Rhinestone Cowboy - Glen Campbell
Still Falling For You - Ellie Goulding 
My Universe - Coldplay, BTS
I Love You - Celine Dion 
Love Is A Wonderful Thing - Michael Bolton 
Wonderful Tonight - Eric Clapton 
Kiss Me - Sixpence None The Richer 
Salade De Fruits - Lisa Ono 
Un Roman D'amitie - Elsa, Glenn Medeiros 
We've Got Tonight - Kenny Rogers & Sheena Easton 
Everytime You Go Away - Paul Young 
Knife - Rockwell 
Straight From My Heart - Richard Marx
As Long As You Love Me - Backstreet Boys 
What Can I Do - The Corrs 
When We Were Young - Adele 
Believer - Imagine Dragons 
I Have A Dream - ABBA
Any Dream Will Do - Jason Donovan 
You Win Again - Bee Gees 
Like A Virgin - Madonna 
She Bop - Cyndi Lauper 
Proud Mary - Tina Turner & Elton John & Cher 
Angel - Sarah McLachlan
Driving - Everything But The Girl 
Better Together - Jack Johnson 
Just The Two Of Us - Bill Withers 
(They Long To Be) Close To You - Paris Match 
Just The Way You Are - Bruno Mars 
Sugar - Maroon 5
Stuck - Stacie Orrico 
Hold On - Santana
Barcelona - Ed Sheeran 
Best Day - Loomin 
Everybody Wants To Rule The World - Tears For Fears 
Viva La Vida - Coldplay 
Joyride - Roxette 
Shake It Up - The Cars 
Everybody Have Fun Tonight - Wang Chung 
My All - Mariah Carey 
How Am I Supposed To Live Without You - Michael Bolton 
By Your Side - Sade 
Loving You - Michael Jackson 
Maybe - Jay Sean 
Insomnia - Craig David 
Love Is In The Air - John Paul Young 
Just Once - James Ingram 
Against All Odds - Phil Collins
You're Still The One - Shania Twain 
How Do I Live - Leann Rimes 
Wait For Me - Hall And Oates 
Joanna - Kool & The Gang 
17 - Pink Sweat$
Maybe We Could Be A Thing - Jesse Barrera, Michael Carreon, Albert Posis 
Do You Know Where You're Going To - Diana Ross 
The Heat Is On - Glenn Frey 
Seasons In The Sun - Westlife 
Kokomo - Beach Boys 
Wave - Antonio Carlos Jobim 
What's Up - 4 Non Blondes 
MMMbop - Hanson 
Dynamite - BTS
Better Days - Neiked, Mae Muller, Polo G 
Right Here Waiting - Richard Marx 
Saving All My Love For You - Whitney Houston 
Rivers Of Love - Lisa Ekdahl 
My Cherie Amour - Stevie Wonder 
Don't Say Goodbye - Sergio Mendes & John Legend 
Perhaps Love - John Denver & Placido Domingo
Don't Know Much - Linda Ronstadt & Aaron Neville 
Marry You - Bruno Mars 
Just Friends - Why Don't We
Top Of The World - Carpenters 
River Blue - Alain Morisod & Sweet People 
Mind Games - John Lennon 
Clap Your Hands - Kungs 
I Was Made For Lovin' You - Oliver Heldens (Feat. Nile Rodgers & House Gospel Choir)
Can't Get You Out Of My Head - Kylie Minogue 
Hung Up - Madonna 
The Stranger - Billy Joel 
The Show Must Go On - Queen 
Skyfall - Adele 
A Whiter Shade Of Pale - Procol Harum 
Midnight Blue - Electric Light Orchestra 
Every Second - Mina Okabe 
Il Ballo Del Qua Qua - Al Bano And Romina Power 
How Where When? - Cleo Laine & James Galway 
Turnin’ - Suzanne Ciani & Chyi-Yu  
Dream A Little Dream - Laura Fygi 
Je Ne T’aime Plus - Pink Martini (Feat. Philippe Katerine) 
Only you - Flying Pickets
I Love You - The Bees 
Upside Down - Diana Ross 
Sky High - Jigsaw 
Streets Of Philadelphia - Bruce Springsteen
You May Be Right - Billy Joel  
Love Me Do - The Beatles 
That Thing You Do - The Wonders   
Hearts - Marty Balin 
JoJo - Boz Scaggs 
Good Times - Chic
Bad Girls - Donna Summer 
Knock On Wood - Amii Stewart 
Tonight, I Celebrate My Love - Peabo Bryson & Roberta Flack 
Then You Can Tell Me Goodbye - Bettye Swann   
Sleep All Day - Jason Mraz 
Love Song - Paper Lace 
Give Me Love -George Harrison
Evergreen - Barbra Streisand 
Calypso - John Denver 
Smooth - Santana (Feat. Rob Thomas)
Rude - MAGIC! 
Dizzy - Tommy Roe 
Da Doo Ron Ron - Shaun Cassidy
The Way You Make Me Feel - Michael Jackson 
I’m In Love For The Very First Time - Maywood 
Fresh -Kool & The Gang 
(Shake Shake Shake) Shake Your Booty - KC & The Sunshine Band 
Maneater - Hall & Oates
Take A Chance On Me - ABBA 
Love Will Keep Us Together - Captain & Tennille
The Best - Tina Turner 
Born To Be Wild - Steppenwolf 
YOUTH- Troye Sivan 
Starlight - Westlife 
Dancing Queen - ABBA
La Bamba - Los Lobos 
Mambo Jambo - Perez Prado 
Sweet Child O'Mine - Guns N'Roses 
It's My Life - Bon Jovi 
All By Myself - Jamie O'Neal 
Arthur's Theme (Best That You Can Do) - Christopher Cross
Loving You Girl - Peder Elias (Feat. Hkeem)
So I Could Find My Way - Enya 
Shape Of You - Ed Sheeran 
Beautiful Life - Ace Of Base 
Tonight Is The Night - Le Click 
Mi Mi Mi - Serebro 
I Just Called To Say I Love You - Stevie Wonder 
Pretty Woman - Roy Orbison 
Marvin Gaye - Charlie Puth (Feat. Meghan Trainor) 
Juice - Lizzo 
I Don't Like It, I Love It - Flo Rida (Feat. Robin Thicke & Verdine White)
You - 김민석, 김바울, 박현수, 최성훈
Listening For The Weather - Big Runga 
How Deep Is Your Love - Bee Gees 
Love Is The Answer - England Dan John Ford Coley 
Big Big World - Emilia 
Lemon Tree - Fool's Garden 
Always On My Mind - Pet Shop Boys 
Get Outta My Dreams, Get Into My Car - Billy Ocean 
It Must Have Been Love - Roxette 
(You Drive Me) Crazy - Britney Spears
Bills - LunchMoney Lewis 
Let Me Be There - Olivia Newton John 
Islands In The Stream - Dolly Parton, Kenny Rogers 
Living Next Door To Alice - Smokie 
Now And Forever - Richard Marx 
When I Dream - Carol Kidd
If - Bread
Yours - Conan Gray 
Over And Over Again - Nathan Sykes, Ariana Grande 
25 Minutes - Micheal Learns To Rock 
Blinding Lights - The Weeknd 
Eye Of The Tiger - Survivor 
Can't Stop Lovin' You - Van Halen
On The Floor - Jennifer Lopez 
Sweet Dreams - Eurythmics 
A Thousand Miles - Venessa Carlton 
Everywhere - Michelle Branch 
Going Back West - Boney M 
You Make Me Feel Like Dancing - Leo Sayer 
That's The Way (I Like It) - KC & The Sunshine Band 
Parachute - John K 
Walk Right In - Dr.Hook 
Summer Nights - John Travolta & Olivia Newton John 
Everyday - Troy, Gabriella 
Kiss Me More - Doja Cat (Feat. SZA) 
Watermelon Sugar - Harry Styles 
I Am Better Off - Wildson (Feat. Lakesha Nugent)
You Make Me Feel Brand New - Stylistics 
Reunited - Peaches & Herb 
Because Of You - Ne-Yo 
Directo Al Corazon - Luis Miguel 
Heaven Is A Place On Earth - Belinda Carlisle 
I Can Dream About You - Dan Hartman 
Superstar - Jamelia 
Shut Up - Black Eyed Peas 
Surfin' USA - Beach Boys 
Tarzan Boy - Baltimora 
Somewhere Over The Rainbow / What A Wonderful World - Israel Kamakawiwo'ole 
Bring It All Back - S Club 7 
I'll Meet You At Midnight - Smokie 
I Really Like You - Carly Rae Jepsen 
How to Love (feat. Sofia Reyes) - Cash Cash 
Lonely Together (feat. Rita Ora) - Avicii  
Summer Wine - Nancy Sinatra & Lee Hazlewood 
Love Is In Your Eyes - Gerard Joling 
Everybody Loves Somebody Sometime - Dean Martin 
Ai No Corrida -  Quincy Jones, Charles May
Play That Funky Music - Wild Cherry
1979 - Smashing Pumpkins 
Come On Over - Christina Aguilera 
Juliet - LMNT 
Kiss Me - Sixpence None The Richer 
Just Wanna Dance Tonight - Trix 
Mickey - Toni Basil 
Like1999 - Valley 
Eyes On You - Nicky Youre 
You Are My Sunshine - Papa Winnie 
Beautiful Life - Ace Of Base 
Dreams - The Cranberries 
Beat It - Michael Jackson 
This Is Me - Keala Settle & The Greatest Showman Ensemble
Thunder - Imagine Dragons 
Pray For Me - Kendrick Lamar & The Weeknd 
Danger Zone - Kenny Loggins 
It's My Life - Bon Jovi 
Love Love Love - Hope (Feat. Jason Mraz) 
10,000 Hours - Dan + Shay, Justin Bieber 
Someone Like You - Adele 
Shape Of My Heart - Sting 
Swiss Boy - Lou Sern 
Manic Monday - Bangles 
Nothing's Gonna Stop Up Now - Starship 
Be My Baby - The Ronettes 
Isn't She Lovely - Stevie Wonder 
Spring Waltz - Carla Bruni 
Pretty World - Lisa Ono 
Blurred Lines - Robin Thicke (Feat. T.I. / Pharrell Williams)
24K Magic - Bruno Mars 
Ordinary Miracle - Sarah McLachlan 
Eye In The Sky - The Alan Parsons Project 
What's Up - 4 Non Blondes 
MMMBop - Hanson 
Basket Case - Green Day 
Oops.. I Did It Again - Britney Spears 
It's Gonna Be Me - N Sync 
Nice To Meet Ya - Niall Horan 
Say So - Doja Cat 
Shut Up - Mia Rodriguez 
Numb - Marshmello, Khalid  
Fallin’ In Love - Hamilton, Joe Frank And Reynolds 
Sea Of Heartbreak -Poco 
Long, Long Time - Linda Ronstadt
Welcome To My World - The Anita Kerr Singers
Come Fly With Me - Frank Sinatra
Count On Me - Bruno Mars 
You, Dear - Eloise 
Killing Me Softly With His Song - Roberta Flack 
I Can't Tell You Why - Eagles 
On The Radio - Donna Summer 
Only You - Flying Pickets
Can’t Smile Without You - Barry Manilow
Aubrey - Bread 
Turning - Suzanne Ciani & Chyi-Yu
I’m Every Woman - Chaka Khan 
Fantasy - Earth, Wind & Fire 
Get Down On It - Kool & The Gang
Stars - Simply Red
High Enough - Damn Yankees
Holiday - Bee Gees 
You're Only Lonely - J.D.Souther 
Walk Right In - Dr. Hook 
Tarzan Boy - Baltimora
Boys - Sabrina 
Sailing - Rod Stewart 
The Rose - Bette Midler
Rosanna - Toto
Don’t Bring Me Down - Electric Light Orchestra 
Homesick - Dua Lipa     
Love Is In The Air - John Paul Young
Sweet Caroline - Neil Diamond
Love's Been a Little Bit Hard on Me - Juice Newton
We Go Together - John Travolta, Olivia Newton John 
I Can't Decide  - Scissor Sisters 
Voulez-Vous - ABBA 
She Bop - Cyndi Lauper
Call Me - Spagna 
Big Jet Plane -  Angus And Julia Stone 
Good Day - DNCE 
Dizzy - Tommy Roe 
Do Wah Diddy Diddy - Manfred Mann 
Plaisir D'amour - Nana Mouskouri 
Champagne - Andrea Bocelli 
You've Got A Friend In Me - Randy Newman 
Nothing From Nothing - Billy Preston 
That's What Friends Are For - Dionne & Friends 
End Of The Road - Boyz II Men 
New Divide - Linkin Park 
I Ain't Worried - OneRepublic 
Here Comes The Sun - James Taylor & Yo-Yo Ma 
Seasons In The Sun - Westlife 
Love Song - Sara Bareilles 
I Will Survive - Gloria Gaynor 
Fame - Irene Cara 
Wanted - The Dooleys 
Harlem Desire - London Boys 
Blow Your Mind - Dua Lipa 
We Found Love - Rihanna 
Happy! - Mocca
Don't Worry Be Happy - Bobby McFerrin 
Hakuna Matata - Nathan Lane, Ernie Sabella, Jason Weaver, Joseph Williams
Heartbeat - Wham 
Popular Song - Mika (feat. Ariana Grande) 
Made You Look - Meghan Trainor 
Don't You Worry 'Bout A Thing - Tori Kelly 
Kung Fu Fighting - Carl Douglas 
Do You Wanna Funk - Sylvester 
Rise Up - Andra Day 
Go West - Pet Shop Boys 
Dur Dur D'etre Bebe! - Jordy 
Happy Song - Boney M 
Everybody Have Fun Tonight - Wang Chung 
Dynamite - Rise Up Children's Choir 
Try Everything - Shakira 
Splendor In The Grass - Pink Martini 
Memories - Zita (Feat. Ben Woodward) 
All By Myself - Eric Carmen 
March, April, May - Wouter Hamel 
Jambalaya (On The Bayou) - Carpenters 
Paloma Blanca - George Baker Selection 
Big Big World - Emilia 
Truly - Lisa Lovbrand 
Lucky - Jason Mraz & Colbie Caillat 
Loving You Girl - Peder Elias (Feat. Hkeem) 
If You Leave Me Now - Chicago 
Nothing's Gonna Change My Love For You - George Benson 
Girl On Fire - Alicia Keys 
Polonaise - Jon And Vangelis 
Let Me Be There - Olivia Newton John 
Stumblin' In - Suzi Quatro & Chris Norman
Ob-La-Di, Ob-La-Da - The Beatles 
Heaven - Bryan Adams 
Love Of My Life - Queen 
The Ocean - Mike Perry (Feat. Shy Martin) 
Anywhere - Rita Ora 
Now And Forever - Richard Marx 
Fields Of Gold - Eva Cassidy 
One Moment In Time - Whitney Houston 
My Way - Frank Sinatra 
Still Life - Annie Haslam 
Islands In The Stream - Dolly Parton, Kenny Rogers 
When You're In Love With A Beautiful Woman - Dr.Hook 
My Sharona - The Knack 
Love Potion No.9 - The Searchers 
YOUTH - Troye Sivan 
Light Switch - Charlie Puth 
Serenade To Spring - Secret Garden 
Ai No Corrida - Quincy Jones, Charles May 
Venus - Bananarama 
Kiss - Prince 
Play That Funky Music - Wild Cherry 
Today - John Denver 
The Boxer - Simon And Garfunkel 
Permission To Dance - BTS 
people pleaser - Cat Burns 
Beautiful People - Ed Sheeran (feat. Khalid) 
The Power Of Love - Celine Dion 
Andante, Andante - ABBA 
Easy - Commodores 
My Life - Billy Joel 
The Loco-Motion - Kylie Minogue 
Together Forever - Rick Astley 
Off My Face - Justin Bieber 
Like My Father - JAX 
Missing You - John Waite 
De Do Do Do De Da Da Da - The Police 
All Of Me - John Legend 
Take On Me - A-ha
Another Cha Cha - Santa Esmeralda 
She Bangs - Ricky Martin 
Dragostea Din Tei - O-Zone 
Who Let The Dogs Out - Baha Men 
Flowers - Miley Cyrus 
Adore You - Harry Styles 
Die For You - The Weeknd, Ariana Grande 
Without You - Mariah Carey 
I.O.U. - Carry & Ron 
Beautiful Sunday - Daniel Boone 
The Morning After - Maureen Mcgovern 
We've Only Just Begun - Carpenters
Handy Man - James Taylor 
At Seventeen - Janis Ian 
Heart Of Gold - Neil Young
Ventura Highway - America 
Smile Again - Newton Family
Almost Over You - Sheena Easton 
Paint My Love - Michael Learns To Rock
The Lazy Song - Bruno Mars
Sugar Sugar - The Archies
Listen To The Music - The Doobie Brothers
Breaking Up Is Hard To Do - Neil Sedaka
Only The Lonely - Roy Orbison
Heart Of Glass - Blondie
Never Too Late - Kylie Minogue
Sara - Starship 
Ever Since The World Began - Survivor 
My Cherie Amour - Stevie Wonder 
Our Last Summer - Amanda Seyfried, Colin Firth, Meryl Streep, Pierce Brosnan, Stellan Skarsgard  
Love Of My Life - Dooleys 
Beyond The Blue Horizon - Lou Christie 
San Francisco - Scott Mckenzie 
Sea Of Love - The Honeydrippers    
Donna - Los Lobos 
One Night In Bangkok - Murray Head  
첨밀밀 - 등려군
Faith - George Michael 
Shout  - Tears For Fears
Dangerous -Michael Jackson
Cantaloop - Us3 
Love Story - Taylor Swift  
Call Me Maybe - Carly Rae Jepsen
Just The Way You Are - Bruno Mars 
Here I Am - Air Supply
You And I - Scorpions 
Working For The Weekend - Loverboy
Friday Night - Arabesque 
Le Freak - Chic 
Vincent - Don Mclean 
La Vie En Rose - Louis Armstrong 
Shape Of You - Ed Sheeran 
Havana - Camila Cabello (Feat. Young Thug) 
Hold On - Santana 
Steal Away - Robbie Dupree 
I Remember - Mocca 
Smoke On The Water - Deep Purple 
Piano Man - Billy Joel 
With Or Without You - U2 
It's My Life - Bon Jovi 
Whistle - Flo Rida 
EX - Kiana Lede 
Reality - Richard Sanderson 
L-O-V-E - Gregory Porter 
You Are The Sunshine Of My Life - Lisa Ono 
Volare - Gypsy Kings 
Oh I Love You So - Preston Smith 
Sun Of Jamaica - Goombay Dance Band 
Hands Up - Ottawan
My Love - Westlife 
All For You - Cian Ducrot 
Stronger (What Doesn't Kill You) - Kelly Clarkson 
Counting Stars - OneRepublic 
Years - Barbara Mandrell 
I Have A Dream - ABBA
Believer - Imagine Dragons 
Fire On Up - Paper Kings 
Handclap - Fitz And The Tantrums 
We Are Young - Fun. (Feat. Janelle Monae) 
Skater Boi - Avril Lavigne 
We Are The Champions - Queen 
It Ain't Over Until It's Over - Lenny Kravitz 
You To Me Are Everything - The Real Thing 
Happy Days - Pratt And McClain 
More Than I Can Say - Leo Sayer 
What A Fool Believes - The Doobie Brothers 
Small Talk - The Real Group 
Can't Sleep Love - Pentatonix 
Somebody's Watching Me - Rockwell 
Rock Me Amadeus - Falco 
Give Me A Kiss - Crash Adams 
Red - Taylor Swift 
Everything's Gonna Be Alright - Sweetbox
Everybody's Changing - Keane 
Gimme Gimme - Johnny Stimson 
Gimme - Sam Smith, Koffee, Jessie Reyez 
Blinding Lights - The Weeknd 
Que Sera Mi Vida - Gibson Brothers 
Sweet Soul Music - London Boys 
Macho Man - Village People 
Lost In love - Air Supply 
Alone Again (Naturally) - Diana Krall & Michael Buble 
The Drum - Alan Walker 
You Needed Me - Anne Murray 
Spring, Summer, Winter And Fall - Aphrodite's Child 
I've Been Away Too Long - George Baker Selection 
Come On Eileen - Dexys Midnight Runners 
Love Shack - The B-52's 
Upside Down - A-Teens 
Celebrate - Mika (feat. Pharrell Williams) 
Everybody Wants You - Billy Squier 
You Gotta Be - Des'ree
Lost Stars - Adam Levine 
Live Is Life - Opus 
Superstition - Stevie Wonder & Jeff Beck 
Uptown Funk - Mark Ronson, Bruno Mars 
Push The Botton - Sugababes 
Doctor Jones - Aqua 
I Can't Stop Loving You - Papa Winnie 
Dangerously - Charlie Puth 
Beggin' - Maneskin 
Circles - Post Malone 
Hooked On Classics Parts 1 And 2 - Louis Clark & Royal Philharmonic Orchestra 
You Win Again - Bee Gees 
Gloria - Laura Branigan 
When I Need You - Leo Sayer 
Greatest Love Of All - Whitney Houston 
Dancing Queen - ABBA
Sexy Music - The Nolans 
Happiness - The 1975
Think - Aretha Franklin 
The Game Of Love - Santana (feat. Michelle Branch)2부 1. Fighter - Royal Deluxe 2. Viva La Vida - Coldplay 3. The Phoenix - Fall Out Boy 4. My Own Hero - Andy Grammer 5. Bring It All Back - S Club 7 6. See Ya - Atomic Kitten 7. 2002 - Anne- Marie 8. Because You Loved Me - Celine Dion 9. I Can Love You Like That - All-4-One  Fool (If You Think It's Over) - Chris Rea 
Fighter - Royal Deluxe 
Viva La Vida - Coldplay 
The Phoenix - Fall Out Boy 
My Own Hero - Andy Grammer 
Bring It All Back - S Club 7 
See Ya - Atomic Kitten 
2002 - Anne- Marie 
Because You Loved Me - Celine Dion 
I Can Love You Like That - All-4-One 
Fool (If You Think It's Over) - Chris Rea 
Love Is An Open Door - Kristen Bell, Santino Fontana
Tiger In The Night - Colin Blunstone  
The Water Is Wide - Karla Bonoff
I Shall Sing - Art Garfunkel 
Silly Love Songs - Paul McCartney
Black Or White - Michael Jackson
Just Walk Away - Celine Dion   
My All - Mariah Carey 
Smooth Operator - Sade 
Moon River - Audrey Hepburn  
Have I Told You Lately - Rod Stewart 
You've Got A Friend - James Taylor
My Sweet Lady - John Denver 
I Feel Love - Donna Summer 
Flying Without Wings - Westlife
All About You - McFly 
She - Elvis Costello 
She Loves You - Beatles 
Baby Driver - Simon & Garfunkel 
Johnny B.Good - Chuck Berry 
For The First Time - Kenny Loggins
It Must Have Been Love - Roxette
Paradise - Phoebe Cates
I Saw You Dancing - Yakida 
Brave - Jennifer Lopez 
What You Do (Feat. Ne-Yo) - Chrisette Michele 
Xanadu - Olivia Newton John
Jump - Van Halen 
Keep On Loving You - Reo Speedwagon
Don’t Know Why - Norah Jones 
I Just Want To Be Your Everything - Andy Gibb
You're The First, The Last, My Everything - Barry White
Sweet Love - Anita Baker 
Hearts - Marty Balin
You - Ten Sharp
Technicolor Dreams - Bee Gees 
I'm Yours - Jason Mraz 
Way Back Into Love - Hugh Grant &amp; Heley Bennett
Colors Of The Wind - Vanessa Williams 
A Whole New World - Mena Massoud, Naomi Scott 
Physical - Dua Lipa 
Instruction - Jax Jones (Feat. Demi Lovato, Stefflon Don)
The Time Of My Life - Bill Medley &amp; Jennifer Warnes 
Private Eyes - Hall &amp; Oates 
Still Fighting It - Ben Folds Five 
Radio Ga Ga - Queen 
Morning Train - Sheena Easton 
Uptown Girl - Westlife 
Breathless - The Corrs 
Dust In The Wind - Kansas 
Sisyphus - Andrew Bird 
Problem - Ariana Grande (Feat. Iggy Azalea) 
We No Speak Americano - Yolanda Be Cool &amp; Dcup 
Paso (The Nini Anthem) - Sak Noel
Somewhere Only We Know - Keane 
Step By Step - New Kids On The Block 
Words - F.R.David 
When Doves Cry - Prince 
Lovin' You - Minnie Riperton 
I Just Can't Stop Loving You - Michael Jackson (Feat.Siedah Garrett)
When I Get Old - Christopher, 청하 
There's Nothing Holding Me Back - Shawn Mendes 
Baby Come Back - Player 
Emotion - Samantha Sang 
Baby I Love You - Mamas Gun 
Who Are You - The Who 
Tonight Is The Night - Le Click 
Run Away - Real McCoy 
Sweet Dreams - Eurythmics 
Kiss The Sky - Jason Derulo 
Worth It - Fifth Harmony (Feat. Kid Ink) 
Done For Me - Charlie Puth (feat. Kehlani) 
Save Your Tears - Weeknd, Ariana Grande 
What's Been On Your Mind? - Surfaces 
You Got It - Roy Orbison 
Don't Go Breaking My Heart - Elton John & Kiki Dee 
Bad, Bad Leroy Brown - Jim Croce 
Girls Just Wanna Have Fun - Cyndi Lauper 
Footloose - Kenny Loggins 
Everytime You Go Away - Paul Young 
Alone - Heart 
Another Day In Paradise - Phil Collins 
Bridge Over Troubled Water - Simon And Garfunkel 
Fixing A Broken Heart - Indecent Obsession 2부 1. you were there for me - Henry Moodie 2. Always On My Mind - Pet Shop Boys 3. Hungry Like The Wolf - Duran Duran 4. Happy Song - Boney M5. Romeo - Donna Summer 6. Never Gonna Give You Up - Rick Astley 7. Made You Look - Meghan Trainor 8. Special - Lizzo (Feat. SZA)9. Diamonds - Rihanna  Unstoppable - Sia 
you were there for me - Henry Moodie 
Always On My Mind - Pet Shop Boys 
Hungry Like The Wolf - Duran Duran 
Happy Song - Boney M
Romeo - Donna Summer 
Never Gonna Give You Up - Rick Astley 
Made You Look - Meghan Trainor 
Special - Lizzo (Feat. SZA)
Diamonds - Rihanna 
Unstoppable - Sia 
I Want You Back - The Jackson 5
L-O-V-E - Olivia 
Let There Be Love - Chris Botti & Michael Buble 
I Just Called To Say I Love You - Stevie Wonder 
Love Is A Wonderful Thing - Michael Bolton 
Let It Be Me - New Trolls 
Can't Help Falling In Love - Elvis Presley & The Royal Philharmonic Orchestra 
Gimme Gimme Gimme - ABBA 
Halo - Beyonce 
Valentine Girl - New Kids On The Block 2부 1. When You Believe - Celtic Woman 2. Evergreen - Susan Jacks 3. Top Of The World - Carpenters 4. How Deep Is Your Love - Bee Gees 5. Fall In Love Alone - Stacey Ryan 6. Ride With Me - Pink Sweat$7. Butterflies - MAX, Ali Gatie 8. Endless Love - Lionel Richie & Diana Ross9. Wind Beneath My Wings - Bette Midler  To Be With You - Mr.Big 
When You Believe - Celtic Woman 
Evergreen - Susan Jacks 
Top Of The World - Carpenters 
How Deep Is Your Love - Bee Gees 
Fall In Love Alone - Stacey Ryan 
Ride With Me - Pink Sweat$
Butterflies - MAX, Ali Gatie 
Endless Love - Lionel Richie & Diana Ross
Wind Beneath My Wings - Bette Midler 
To Be With You - Mr.Big 
Love Grows - Edison Lighthouse 
Lonely Teardrops - Howard Huntsberry 
Heaven Must Be Missing An Angel - Tavares 
Anti-Hero - Taylor Swift 
Broke Boy - Malia Civetz 
Make You Feel My Love - Adele 
Right Here Waiting - Richard Marx 
Kiss Me Thru The Phone (Feat. Sammie)  - Soulja Boy Tell'em 
Dilemma (Feat. Kelly Rowland) - Nelly 
Begin Sweet World - Richard Stoltzman 
Early In The Morning - Cliff Richard  
Angel Of The Morning - Juice Newton 
Spread Your Wings - Queen 
Monday Morning 
19 - Rialto  Jump (For My Love) - Pointer Sisters 
Billie Jean - Michael Jackson 
HEY CHILD - X Ambassadors 
Burn The House Down - AJR 
Memories - Conan Gray 
Good Day - Surfaces 
My Love - Lionel Richie 
We’ll Be One By Two Today - Lobo 
Rose Garden - Lynn Anderson 
Beautiful - Jennifer Paige 
Love Takes Time - Mariah Carey 
Beautiful Day - U2
Africa - Toto 
You're The Inspiration - Chicago
Faithfully - Journey
Stay With Me Till The Morning - Dana Winner
Un Giorno Per Noi (A Time For Us) - Paul Potts 
Let It Be - John Denver  
Travellin' - The Jeremy Spencer Band 
Best Of My Love - The Emotions
Fresh - Kool & The Gang
Sriracha - Marteen 
Overpass Graffiti - Ed Sheeran 
The Weekend -88rising, BIBI 
Looks Like We Made It - Barry Manilow 
I’ll Never Fall In Love Again - Dionne Warwick
Cachito - Lisa Ono
Rico Vacilon - Karl Zero & Karlette's
We Built This City- Starship
Maria - Blondie
I Should Be So Lucky - Kylie Minogue
Love In The First Degree - Bananarama
When A Man Loves A Woman - Michael Bolton
A Little Peace - Nicole
Mrs.Robinson - Simon & Garfunkel 
If Not For You - Olivia Newton John
Eye In The Sky - The Alan Parsons Project
Little Lies - Fleetwood Mac 
Don't Know Much - Linda Ronstadt & Aaron Neville
Tonight I Celebrate My Love - Roberta Flack, Peabo Bryson
Listening For The Weather - Bic Runga
Back For Good - Take That
Angel - Forestella 
Scarborough Fair - Sarah Brightman 
May It Be - Enya 
Oh My Love - John Lennon 
If - Bread 
Raindrops Keep Falling On My Head - B.J.Thomas 
(They Long to Be) Close To You - Harry Connick Jr. 
Arthur's Theme (Best That You Can Do) - Christopher Cross
Take A Picture - Mamas Gun 
The Look Of Love - Dusty Springfield 2부 1. Rain And Tears - Aphrodite's Child 2. If You Think You Know How To Love Me - Smokie 3. Sister Golden Hair - America 4. Dreams - The Cranberries 5. Until I Found You - Stephen Sanchez, Em Beihold 6. Perfect Duet (With Beyonce)  - Ed Sheeran 7. Emotions - Mariah Carey 8. All For You - Janet Jackson 9. Falling - Harry Styles  When I Was Your Man - Bruno Mars 
Rain And Tears - Aphrodite's Child 
If You Think You Know How To Love Me - Smokie 
Sister Golden Hair - America 
Dreams - The Cranberries 
Until I Found You - Stephen Sanchez, Em Beihold 
Perfect Duet (With Beyonce)  - Ed Sheeran 
Emotions - Mariah Carey 
All For You - Janet Jackson 
Falling - Harry Styles 
When I Was Your Man - Bruno Mars 
Mocking Bird Hill - Patti Page 
Somewhere Over The Rainbow / What A Wonderful World - Israel Kamakawiwo'ole 
Don't Worry Be Happy - Bobby McFerrin 
Mamma Mia - Meryl Streep 
Seasons Of Love - Jonathan Larson 
Take Me Home Country Roads - John Denver 
Right Down The Line - Gerry Rafferty 
50 Ways To Say Goodbye - Train 
Hey Brother - Avicii
You Are My Sunshine - Elizabeth Mitchell & Daniel Littleton 
You Light Up My Life - Debby Boone 
Can't Help Falling In Love - UB40
Baby I Love Your Way - Big Mountain 
Macarena - Los Del Rio 
My Heart Will Go On - Celine Dion 
A Lover's Concerto - Sarah Vaughan 
Unchained Melody - The Righteous Brothers 
When I Dream - Carol Kidd 
Ballade Pour Adeline - Richard Clayderman 
Sing - Carpenters 
Clair - Gilbert O'sullivan 
Then Came You - Dionne Warwick & The Spinners 
Reflections Of My Life - Marmalade 
House Of The Rising Sun - The Animals 
Perhaps Love - John Denver & Placido Domingo 
I Can't Stop Lovin' You - Ray Charles 
I Was Born To Love You - Queen 
Speak Softly Love - 박주원 (Feat. 최백호) 
At My Worst - Pink Sweat$ 2부 1. The Prayer - Celine Dion & Andrea Bocelli 2. Can't Take My Eyes Off You - Morten Harket 3. You're Only Lonely - J.D.Souther 4. In Dreams - Roy Orbison 5. Dreamers - 정국, 방탄소년단 (Feat. FIFA Sound, Fahad Al Kubaisi) 6. Lionheart (Fearless) - Joel Corry, Tom Grennan 7. I'm Good (Blue) - David Guetta, Bebe Rexha 8. Freedom - Wham 9. Let's Hear It For The Boy - Deniece Williams  Love Me Like You Do - Ellie Goulding 
The Prayer - Celine Dion & Andrea Bocelli 
Can't Take My Eyes Off You - Morten Harket 
You're Only Lonely - J.D.Souther 
In Dreams - Roy Orbison 
Dreamers - 정국, 방탄소년단 (Feat. FIFA Sound, Fahad Al Kubaisi) 
Lionheart (Fearless) - Joel Corry, Tom Grennan 
I'm Good (Blue) - David Guetta, Bebe Rexha 
Freedom - Wham 
Let's Hear It For The Boy - Deniece Williams 
Love Me Like You Do - Ellie Goulding 
Dance Mot Var (Dance Towards Spring) - Anne Vada
The Rose - Bette Midler 
Open Arms - Journey 
Hungry Eyes - Eric Carmen 
Nowhere Fast - Fire Inc. 
Easy On Me - Adele 
GHOST TOWN - Benson Boone 
Every Breath You Take - The Police 
City Of Blinding Lights - U2 
Slowly - Ann-Margret 
Heal The World - Michael Jackson 
Home - Michael Buble 
A Love That Will Last - Renee Olstead 
As It Was - Harry Styles 
Late Night Talking - Harry Styles 
About Damn Time - Lizzo 
Unholy - Sam Smith, Kim Petras 
Your Song - Elton John 
It Might Be You - Stephen Bishop 
Turn Back The Clock - Johnny Hates Jazz 
Love Is In The Air - John Paul Young 
River Blue - Alain Morisod & Sweet People 
Move On - ABBA
Thinking Out Loud - Ed Sheeran 
10,000 Hours - Dan & Shay, Justin Bieber 
Hurts So Good - John Cougar Mellencamp 
Do You Believe In Love - Huey Lewis And The News 
I'll Be Waiting - Cian Ducrot 
Be Alright - John K 
L.U.S.H - New Hope Club 
You Raise Me Up - Celtic Woman 
I Want To Break Free - Queen 
It's My Life - Bon Jovi
I'm Not Here To Make Friends - Sam Smith 
Flowers - Miley Cyrus 
Kiss Me More - Doja Cat (Feat. SZA) 
Hard To Say I'm Sorry - Chicago 
I Can Wait Forever - Air Supply 
Lemon Tree - Fool's Garden 
Sour Strawberry - Caroline Manning 
Dancing In The Moonlight - Toploader 
Just When I Needed You Most - Randy VanWarmer
A Love Until The End Of Time - Placido Domingo & Maureen Mcgovern
Rocket Man - Elton John  
I'd Really Love To See You Tonight - England Dan & John Ford Coley
Into The Groove - Madonna 
Maniac - Michael Sembello
Hey Eugene - Pink Martini 
Hold On Tight - Jesse Barrera, Albert Posis  
Sky High - FreeTEMPO  (Feat. Maynard Plant)
We Are The World - USA For Africa  
It's So Easy - Linda Ronstadt 
Queen Of Hearts - Juice Newton 
Southern Nights - Glen Campbell
Love Shine A Light - Katrina And The Waves
Lost Stars - Keira Knightley
Falling Slowly - Glen Hansard & Marketa Irglova
Bang Bang - Jessie J, Ariana Grande, Niki Minaj
Runaway Baby - Bruno Mars  
Music - F.R.David 
Turn Turn Turn - The Byrds
Lost In Love - Air Supply
You Call It Love - Karoline Kruger  
Honey Honey - ABBA 
That Thing You Do - The Wonders
Sometimes - Britney Spears
Everything You Do - M2M 
Semi-Charmed Life - Third Eye Blind
Only Hope - Mandy Moore
When We Were Young - Adele 
The Lady In Red - Chris De Burgh
Stand By Your Man - Carla Bruni 
More Than Words - Extreme
The Logical Song - Supertramp 
Abracadabra - Steve Miller Band 
25 Minutes - Michael Learns To Rock
I Don’t Want To Miss A Thing - Aerosmith 
Gloria - Laura Branigan
Stars On 45  (Beatles Medley) - Stars On 45
My Universe - Coldplay, 방탄소년단 
Joanna - Kool & The Gang
Tonight - New Kids On The Block
St.Elmo's Fire - John Parr 
Centerfold - J.Geils Band 
Hero - Mariah Carey 
Listen - Beyonce 
I Feel It Coming (feat. Daft Punk) - The Weeknd  
Dancing With A Stranger - Sam Smith, Normani 
My Life - Billy Joel 
Wanted - Dooleys 
London Nights - London Boys 
Touch By Touch - Joy
I Will Always Love You - Whitney Houston
I Swear - All - 4 - One 
Chilly Cha Cha - Jessica Jay 
Latin Lover - Popsie
On The Floor - Jennifer Lopez
One Love - Blue  
Roar- Katy Perry  
Good Time - Carly Rae Jepsen & Owl City 
Celebration - Kool And The Gang 
Happy - Pharrell Williams 
Jambalaya - Carpenters 
Let Me Be There - Olivia Newton John 
Love Never Felt So Good - Michael Jackson 
Thinkin Bout You - Ciara 
La Bamba - Los Lobos 
Fun, Fun, Fun - Beach Boys
Viens Valse Avec Papa - Andre Claveau 
Handclap - Fitz And The Tantrums 
Y.M.C.A - Village People 
She Bop - Cyndi Lauper 
You're My Heart, You're My Soul - Modern Talking 
Chandelier - Sia 
Attention - Charlie Puth 
Stayin' Alive - Bee Gees 
I Will Survive - Gloria Gaynor 
Sunroof - Nicky Youre, Dazy 
Better Days - Neiked, Mae Muller, Polo G 
Good Morning Baltimore - Nikki Blonsky 
Stumblin' In - Suzi Quatro & Chris Norman 
In Your Letter - REO Speedwagon 
Misty Blue - Dorothy Moore
Misty - Johnny Mathis 
One Way Ticket - Eruption 
Call Me - Blondie 
Flowers - Miley Cyrus
The Power - SNAP
Dragostea Din Tei - O-Zone 
One Night Only - Beyonce, Sharon Leal, Anika Noni Rose 
Boogie Wonderland - Earth, Wind And Fire 
Part-Time Lover - Stevie Wonder 
Don't Stop Me Now - Queen 
Dynamite - Rise Up Children's Choir 
Woman In Love - Barbra Streisand 
Be My Baby - The Ronettes 
(You Are) More Than Paradise - Port Of Notes 
I Ain't Worried - OneRepublic 
Sunny - Boney M 
Fame - Irene Cara 
Another Day Of Sun - La La Land Cast 
You're The One That I Want - Glee Cast
Beat It - Michael Jackson 
Bad Case Of Loving You - Robert Palmer 
people pleaser - Cat Burns
Ghost Of You - Mimi Webb 
Eight Days A Week - The Beatles 
Eat You Up - Angie Gold 
Kung Fu Fighting - Carl Douglas
Tarzan Boy - Baltimora 
Stronger - Kelly Clarkson 
Me Too - Meghan Trainor 
Boom - X Ambassadors
Listen To My Heart - Gareth Gates 
My Love - Westlife 
Hey Laura - Gregory Porter 
Because Of You - Ne-Yo 
Born To Be Alive - Patrick Hernandez
Go West - Pet Shop Boys
Victory - Koreana
I'm In The Mood For Dancin' - The Nolans 
Dancing Queen - ABBA
Take On Me - A-Ha
Blinding Lights - The Weeknd 
Both Sides Now - Emilia Jones 
Feels So Good - Chuck Mangione 2부 1. Genghis Khan - Genghis Khan 2. Try Everything - Shakira3. We Are Golden - Mika 4. Lucky - Jason Mraz & Colbie Caillat 5. The Show - Lenka 6. We Are Young - Fun. (Feat. Janelle Monae)7. Believer - Imagine Dragons 8. Tide Is High - Atomic Kitten  Don't Look Back In Anger - Oasis 
Genghis Khan - Genghis Khan 
Try Everything - Shakira
We Are Golden - Mika 
Lucky - Jason Mraz & Colbie Caillat 
The Show - Lenka 
We Are Young - Fun. (Feat. Janelle Monae)
Believer - Imagine Dragons 
Tide Is High - Atomic Kitten 
Don't Look Back In Anger - Oasis 
A Winter’s Tale - Queen 
Sloop John B - The Beach Boys 
Bad Moon Rising - Creedence Clearwater Revival 
Tie A Yellow Ribbon Round The Ole Oak Tree - Tony Orlando And Dawn
Rocky Mountain High - John Denver
Over And Over - Nana Mouskouri
Nathalie - Julio Iglesias
Can't Stop Lovin' You - Van Halen 
Holiday - Green Day 
If You Leave Me Now - Chicago 
Wind Of Change - Scorpions  
Paper Mache - Rita Calypso 
Stupid Cupid - Mandy Moore 
Please Mr.Postman - Carpenters
Love Will Keep Us Together - Captain & Tennille 
Hero - Family Of The Year  
You And Me - Gustaf Spetz 
What's Up - 4 Non Blondes
Tubthumping - Chumbawamba
All I Wanna Do - Sheryl Crow 
Do You Want To Build A Snowman? - 영화 ‘겨울왕국’ 중에서 
Piano Man - Billy Joel 
Bohemian Rhapsody - Queen 
Time In A Bottle - Jim Croce
When October Goes - 신해철
Dynamite - BTS
My Heart Will Go On -Celine Dion
One More Time - Richard Marx
You Raise Me Up - Josh Groban 
California Dreamin' - The Mamas And The Papas 
Sailing - Rod Stewart 
Perfect Symphony (With Andrea Bocelli) -Ed Sheeran 
Desperado - 임재범 
Bills - Lunchmoney Lewis 
9 To 5 - Dolly Parton 
Crocodile Rock - Elton John 
Yesterday Once More - Carpenters 
True - Spandau Ballet 
All By Myself - Eric Carmen
I Like Chopin - Gazebo
Girl - F.R.David
Easy Winners - Marvin Hamlisch 
Temple Of The King - Rainbow 2부 1. Left Right Left - Charlie Puth 2. Karma Chameleon - Culture Club 3. The Reflex - Duran Duran 4. Don't Go - Yaz 5. When I Get Old - Christopher, 청하 6. My Way - Cassette 7. 2step - Ed Sheeran (Feat. Lil Baby) 8. Walk Right In - Dr. Hook 9. Walking On Sunshine - Katrina And The Waves  Barbie Girl - Aqua 
Left Right Left - Charlie Puth 
Karma Chameleon - Culture Club 
The Reflex - Duran Duran 
Don't Go - Yaz 
When I Get Old - Christopher, 청하 
My Way - Cassette 
2step - Ed Sheeran (Feat. Lil Baby) 
Walk Right In - Dr. Hook 
Walking On Sunshine - Katrina And The Waves 
Barbie Girl - Aqua 
I'll Be There - Jackson 5
Stand By Me - Ben E.King 
Everybody Is A Star - Sly & The Family Stone 
Angel - Sarah McLachlan 
Ave Maria - Lisa Ono 
Snow Frolic - Francis Lai 
Commnet Te Dire Adieu? - Francoise Hardy
Tombe La Neige - Salvatore Adamo 
Duet - Rachael Yamagata
Perfect To Me - Anne-Marie 
Winter Wonderland / Don't Worry Be Happy - Pentatonix Feat. Tori Kelly 
Falling - Leblanc And Carr 
Longer - Dan Fogelberg
Stay A While - Bells 
Snowman - Sia 
Regent's Park - Bruno Major 
All I Need To Hear - The 1975
Love Is All Around - Wet Wet Wet 
A Shoulder To Cry On - Tommy Page
Eternal Love - Michael Learns To Rock 
The Heat Is On - Glenn Frey 
Nothing's Gonna Stop Us Now - Starship 
(I Just) Died In Your Arms - Cutting Crew 
Waterloo - ABBA
Y.M.C.A. - Village People 
Save The Best For Last - Vanessa Williams 
Breathe Again - Toni Braxton 
Just The Two Of Us - Bill Withers 
Here Comes The Sun - James Taylor & Yo-Yo Ma 
End Of The Road - Boyz II Men 2부 1. Nothing Is Lost (You Give Me Strength) - The Weeknd 2. Let It Go - Idina Menzel 3. This Is Me - Keala Settle & The Greatest Showman Ensemble 4. All The Stars - Kendrick Lamar & SZA 5. Supreme - Robbie Williams 6. Crazy - Gnarls Barkley 7. Killing Me Softly With His Song - Roberta Flack 8. Stairway To Love - George Benson 9. Lust For Life - Iggy Pop  Song 2 - Blur 
Nothing Is Lost (You Give Me Strength) - The Weeknd 
Let It Go - Idina Menzel 
This Is Me - Keala Settle & The Greatest Showman Ensemble 
All The Stars - Kendrick Lamar & SZA 
Supreme - Robbie Williams 
Crazy - Gnarls Barkley 
Killing Me Softly With His Song - Roberta Flack 
Stairway To Love - George Benson 
Lust For Life - Iggy Pop 
Song 2 - Blur 
Marry You - Bruno Mars 
Perfect - Ed Sheeran 
The Power Of Love  -Celine Dion 
She's Gone - Steelheart 
Rivers Of Babylon - Boney M 
Tokyo Town - Sarah
Tears In Heaven - Eric Clapton 
Stairway To heaven - Led Zeppelin 
One Summer Night - 진추하, 아비 2부 1.Butter - 방탄소년단 2. He Ain’t Heavy, He’s My Brother - 들국화 3.I’ve Been Away Too Long - George Baker Selection 4.Honesty - Billy Joel5.Don’t Stop Me Now - Queen 6.Try To Remember - 성시경 7.Hard To Say I’m Sorry - 이소라 8.Now And Forever - 박효신 Vincent - 박정현 
Butter - 방탄소년단 
He Ain’t Heavy, He’s My Brother - 들국화 
I’ve Been Away Too Long - George Baker Selection 
Honesty - Billy Joel
Don’t Stop Me Now - Queen 
Try To Remember - 성시경 
Hard To Say I’m Sorry - 이소라 
Now And Forever - 박효신 
Vincent - 박정현 
첨밀밀 - 등려군
Reality - Richard Sanderson 
Nothing’s Gonna Change My Love For You - George Benson 
Stand By Your Man - Tammy Wynette 
Top Of The World - The Carpenters
Hooked On Classics Part 1 And 2 - Louis Clark
London Nights - London Boys
Brother Louie - Modern Talking 
Goodbye Yellow Brick Road - Elton John
Heaven -Bryan Adams
Hey - Julio Iglesias
Sea Of Heartbreak -Poco
Woman In Love - Barbra Streisand
Take A Chance On Me - ABBA
Sun Of Jamaica - Goombay Dance Band
One Night In Bangkok - Murray Head 
I Have Nothing - Whitney Houston
Someone Like You -Adele 
All I Ever Asked - Rachel Chinouriri
Take Me Home Country Roads - John Denver
You Needed Me - Anne Murray 
I’m In Love For The Very First Time - Maywood
Eldorado - Goombay Dance Band
Kill Bill - SZA
Dust in the Wind - Kansas
Living Next Door to Alice- Smokie
The Final Countdown - Europe 
How Deep Is Your Love - Bee Gees
Andante, Andante - ABBA
I Want To Break Free - Queen
When I Dream - Carol Kidd 
Just When I Needed You Most  - Randy VanWarmer
Let Me Be There  - Olivia Newton John 
Flashdance... What A Feeling - Irene Cara 
Tonight, I Celebrate My Love - Peabo Bryson & Roberta Flack
To Love You More - Celine Dion 
Time To Say Goodbye - Andrea Bocelli & Sarah Brightman 
Forever - Stratovarius 
All Out Of Love - Air Supply
Can’t Smile Without You - Barry Manilow 
Green Green Grass Of Home - Tom Jones
Blowing In The Wind - Peter, Paul & Mary 
Dizzy - Tommy Roe
Sugar Sugar - The Archies 
We Are Family - Sister Sledge
Sky High - Jigsaw
Angels - Robbie Williams 
Liability - Lorde 
How Much I Feel - Ambrosia 
Grace Kelly - Mika
Love On The Weekend - John Mayer
Where Were You In The Morning? - Shawn Mendes 
Rosanna - Toto 
Kiss On My List - Hall & Oates 
Saturday In The Park - Chicago
P.D.A (We Just Don't Care) - John Legend
Love On Top - Beyonce 
That's What Friends Are For - Dionne & Friends
Just Once - James Ingram 
Let's Go - The Cars 
Gotta Go Home - Boney M 
Ai No Corrida - Quincy Jones, Charles May
My Heart Will Go On - Celine Dion 
Kiss From A Rose - Seal 
Lucky Star - Madonna 
Radio Romance - Tiffany 
S.O.S. - ABBA 
I've Never Been To Me - Charlene 
Sign Of The Times - Harry Styles 2부 1. Love Of My Life - Queen 2. Woman - John Lennon 3. More Than I Can Say - Leo Sayer 4. Islands In The Stream - Dolly Parton, Kenny Rogers 5. Kiss Me - Sixpence None The Richer 6. Altogether Alone - Be The Voice7. I'm Yours - Jason Mraz 8. Heat Waves - Glass Animals 9. Sunflower - Post Malone & Swae Lee  Out Of Time - The Weeknd 
Love Of My Life - Queen 
Woman - John Lennon 
More Than I Can Say - Leo Sayer 
Islands In The Stream - Dolly Parton, Kenny Rogers 
Kiss Me - Sixpence None The Richer 
Altogether Alone - Be The Voice
I'm Yours - Jason Mraz 
Heat Waves - Glass Animals 
Sunflower - Post Malone & Swae Lee 
Out Of Time - The Weeknd 
Big Girls Don't Cry - The Four Seasons 
The Oogum Boogum Song - Brenton Wood 
Oh, Pretty Woman - Roy Orbison 
Physical - Olivia Newton John 
Venus - Bananarama 
One More Time - In-Grid 
Latin Lover - Popsie 
The Boss - Diana Ross 
Bad - Michael Jackson 
Let It Be - The Beatles 
The Stranger - Billy Joel 
Everybody - Backstreet Boys 
Can't Fight The Moonlight - Leann Rimes 
Scandalous - Mis-Teeq
The Young Ones - Cliff Richard
Young Lovers - Paul And Paula 
All For The Love Of A Girl - Johnny Horton 
Leave Before You Love Me - Marshmello, Jonas Brothers 
I Just Wanted You - Openside 
I Don't Want Your Money - Mae Muller 
Wait For Me - Hall And Oates 
Mexican Girl - Smokie 
The Way - Fastball 
Turning - Suzanne Ciani & Chyi-Yu 
When She Loved Me - Sarah McLachlan 
Wannabe - Spice Girls 
Mickey - B*Witched 
Golden Hour - JVKE  
Lover / Earth Angel - Joey Stamper 
Fix You - Coldplay 
I Love Rock And Roll - Joan Jett And The Blackhearts 
Video Killed The Radio Star - Buggles 
Hungry Like The Wolf - Duran Duran 
One Way Or Another - Blondie 
Nothin' On You - B.o.B (Feat. Bruno Mars)
I Don't Think That I Like Her - Charlie Puth 
Bad Habits - Ed Sheeran 
She's Like The Wind - Patrick Swayze (Feat. Wendy Fraser)  
Run To You - Whitney Houston 
Mad - Ne-Yo 
jpg','1')' class='bd_link'>화면 캡처 2023-01-17 13365jpg (73,605 Bytes)</a></td></tr></table></td></tr><tr><td><table cellpadding='0' cellspacing='0' class='replybox' width='100%'><colgroup><col width='150' /><col /><col width='70' /></colgroup><tr style='height:20px' align='left' valign='top'><td class='reply_list' style='line-height:15pt;padding-left:8px'><div style='width:150px;overflow:hidden'><div style='width:200px'> <img src='//img.cbs.co.kr/cbs/cbsboard/emoticon/em
I Got You (I Feel Good) - James Brown 
When You're In Love With A Beautiful Woman - Dr.Hook 
For Once In My Life - Stevie Wonder 
Close To You - Carpenters 
Song Sung Blue - Neil Diamond 
Mr.Blue Sky - Electric Light Orchestra 
Live Is Life - Opus 
Livin' La Vida Loca - Ricky Martin 
Hips Don't Lie - Shakira (feat. Wyclef Jean)
One Foot - Walk The Moon 
Sultans Of Swing - Dire Straits 
It Might Be You - Stephen Bishop 
Looks Like We Made It - Barry Manilow 
All Right - Christopher Cross 
Sara Perche Ti Amo - Ricchi E Poveri 
Girls Just Wanna Have Fun - Cyndi Lauper 
So Far So Good - Sheena Easton 
Paint My Love - Michael Learns To Rock 
Deep Green - Christian Kuria 
Stay - The KID LAROI, Justin Bieber
Sunroof - Nicky Youre, Dazy 
Manic Monday - Bangles 
Making Your Mind Up - Bucks Fizz 
Everything - Michael Buble 
L-O-V-E - Natalie Cole 
Young Turks - Rod Stewart 
Heart Of Glass - Blondie 
New Light - John Mayer 
Die For You - The Weeknd 
Adventure Of A Lifetime - Coldplay 
I Can't Tell You Why - Eagles 
Yesterday - The Beatles 
The Sound Of Silence - Simon And Garfunkel 
Dur Dur D'etre Bebe! - Jordy 
Hands Up - Ottawan 
Funky Town - Lipps Inc. 
Bomba - Jessy Matador 
Instruction - Jax Jones (Feat. Demi Lovato, Stefflon Don) 
NO - Meghan Trainor 
Big Big World - Emilia 
Come Fly With Me - Frank Sinatra 
How Where When? - Cleo Laine & James Galway
Dream A Little Dream - Pink Martini, The Von Trapps 
I'm In Love For The Very First Time - Maywood  
Sweet Caroline - Neil Diamond
You're The One That I Want - John Travolta & Olivia Newton-John
Good Morning Baltimore - Nikki Blonsky 
When You Say Nothing At All - Ronan Keating 
I Lay My Love On You - Westlife 
Loving You Girl - Peder Elias (Feat. Hkeem)
Welcome To My World - The Anita Kerr Singers 
Saddle The Wind - Lou Christie
San Francisco - Scott Mckenzie
Puff (The Magic Dragon) - Peter, Paul And Mary
Torn - Natalie Imbruglia
A Thousand Miles - Vanessa Carlton
The Greatest Love We'll Never Know - Rene Froger 
Gira Con Me - Josh Groban 
Beautiful Sunday - Daniel Boone
Build Me Up Buttercup - The Foundations
Happy Girl - Together
Sing - Carpenters
Chiquitita - ABBA 
Hush Little Baby - Yo Yo Ma. Bobby Mcferrin 
Mack The Knife - Bobby Darin 
Morning Train - Sheena Easton
Upside Down - A-Teens
Holiday - Madonna 
The Loco-Motion - Kylie Minogue  
Can’t Take My Eyes Off You - Joey Stamper  
All Out Of Love - Air Supply
I Just Called To Say I Love You - Stevie Wonder 
Don't Go Breaking My Heart - Elton John & Kiki Dee
My Sharona - The Knack 
Knife - Rockwell 
My All - Mariah Carey 
Angel Baby - Troye Sivan
Marvin Gaye - Charlie Puth (feat. Meghan Trainor) 
I Found Heaven - Take That 
What Makes You Beautiful - One Direction
Don't Worry Be Happy - Bobby McFerrin 
Aubrey - Bread 
Just Tell Me You Love Me - England Dan & John Ford Coley 
Rain - Uriah Heep 
Walkin' In The Rain - Marvin Gaye 
I Wish You Love - Lisa Ono 
Desafinado - Lovisa 
Crying In The Rain - A-Ha 
Midnight Blue - Electric Light Orchestra 
It's So Easy - Linda Ronstadt 
Rhythm Of The Rain - The Cascades 
Oops - Little Mix (Feat. Charlie Puth) 
Made You Look - Meghan Trainor 
Wake Me Up Before You Go-Go - Wham 
Ghostbusters - Ray Parker Jr. 
Swiss Boy - Lou Sern 
It Must Have Been Love - Roxette 
Missing You - John Waite 
Like My Father - Jax 
Fall In Love Alone - Stacey Ryan 
Gonna Make You Sweat (Everybody Dance Now) - C + C Music Factory 
Always On My Mind - Pet Shop Boys 
Don't You Want Me - The Human League 
Pretty Boy - M2M
Anyone Of Us - Gareth Gates 
We Are The Champions - Queen 
I'll Stand By You - The Pretenders 
Tom's Diner - DNA & Suzanne Vega 
Now And Forever - Ricahrd Marx
Smooth - Santana (Feat. Rob Thomas) 
Maria - Blondie 
Juliet - LMNT 
Come On Over (All I Want Is You) - Christina Aguilera 
Rivers Of Babylon - Boney M 
Sexy Music - The Nolans 
Havana - Camila Cabello (Feat. Young Thug) 
Bibbidi Bobbidi Boo - Louis Armstrong 
Cause We've Ended As Lovers - Jeff Beck 
Flashdance... What A Feeling - Irene Cara 
Reality - Richard Sanderson 
(Everything I Do) I Do It For You - Bryan Adams 
Last Train To London - Electric Light Orchestra 
Hot Stuff - Donna Summer 
Jet Lag - Simple Plan & Natasha Bedingfield 
Sk8er Boi - Avril Lavigne 
